ID,ALAND,AWATER,npp_p_to12,npp_pco12c,Tot_area,Per_land,NPP_P_mod
ALABAMA_AUTAUGA,1539602137,25706961,10654.36231,17,1565309098,98.357707,6.371917
ALABAMA_BALDWIN,4117621645,1132980868,24993.87994,41,5250602513,78.421888,7.773427
ALABAMA_BARBOUR,2292160139,50523213,15229.97162,25,2342683352,97.843361,6.226267
ALABAMA_BIBB,1612167476,9602089,9617.5047,15,1621769565,99.407925,6.449858
ALABAMA_BLOUNT,1670103866,15015467,12787.24017,19,1685119333,99.108937,6.790635
ALABAMA_BULLOCK,1613076054,6038093,10487.90326,17,1619114147,99.627074,6.192448
ALABAMA_BUTLER,2012002531,2701198,12966.73505,21,2014703729,99.865926,6.182925
ALABAMA_CALHOUN,1569195268,16587192,12276.83362,18,1585782460,98.954006,6.892559
ALABAMA_CHAMBERS,1545085607,16971700,12348.0296,19,1562057307,98.913503,6.57035
ALABAMA_CHEROKEE,1433623319,120308342,10385.62158,15,1553931661,92.25781,7.504782
ALABAMA_CHILTON,1794477075,20592142,12730.08276,20,1815069217,98.86549,6.438082
ALABAMA_CHOCTAW,2365869841,19144469,16831.38519,26,2385014310,99.197302,6.525994
ALABAMA_CLARKE,3207494106,36657891,20359.10767,32,3244151997,98.870032,6.434934
ALABAMA_CLAY,1564251834,5285207,10554.08563,16,1569537041,99.663263,6.618591
ALABAMA_CLEBURNE,1450663786,2354896,9605.471558,14,1453018682,99.837931,6.872189
ALABAMA_COFFEE,1758565919,3907189,11591.94568,19,1762473108,99.778312,6.114579
ALABAMA_COLBERT,1535202321,79700278,10769.68018,16,1614902599,95.064701,7.080494
ALABAMA_CONECUH,2202007855,6632046,14355.56244,23,2208639901,99.699723,6.260347
ALABAMA_COOSA,1685850815,39987271,10149.97235,16,1725838086,97.683023,6.494202
ALABAMA_COVINGTON,2669134207,34226200,17123.1897,28,2703360407,98.733939,6.193843
ALABAMA_CRENSHAW,1576952799,5388562,11109.61707,18,1582341361,99.659456,6.1931
ALABAMA_CULLMAN,1902970816,52525039,12768.1875,19,1955495855,97.313979,6.905584
ALABAMA_DALE,1453244559,4082940,9754.882935,16,1457327499,99.719834,6.113931
ALABAMA_DALLAS,2534919607,39124778,15846.67188,26,2574044385,98.480027,6.188944
ALABAMA_DE KALB,2012676480,4121543,15149.75122,22,2016798023,99.795639,6.899265
ALABAMA_ELMORE,1601768864,99957936,11880.74225,19,1701726800,94.126088,6.64324
ALABAMA_ESCAMBIA,2448115116,20504948,16135.46741,26,2468620064,99.169376,6.257929
ALABAMA_ETOWAH,1385871922,35067763,8869.443298,13,1420939685,97.532072,6.995287
ALABAMA_FAYETTE,1625693288,4330881,12023.13428,18,1630024169,99.734306,6.697313
ALABAMA_FRANKLIN,1641841404,32643981,10856.92053,16,1674485385,98.050507,6.92049
ALABAMA_GENEVA,1487897665,11578163,9704.745117,16,1499475828,99.227853,6.112664
ALABAMA_GREENE,1675782059,33416141,10759.65265,17,1709198200,98.044923,6.455416
ALABAMA_HALE,1667917734,32412739,10649.34863,17,1700330473,98.093739,6.386058
ALABAMA_HENRY,1454926622,16986823,8529.505981,14,1471913445,98.845936,6.163637
ALABAMA_HOUSTON,1501819549,4718092,7322.178955,12,1506537641,99.686825,6.120985
ALABAMA_JACKSON,2791974032,126334709,20398.21515,30,2918308741,95.670961,7.11077
ALABAMA_JEFFERSON,2878552100,32849845,20517.54346,31,2911401945,98.871683,6.694093
ALABAMA_LAMAR,1566544637,1600679,12071.26697,18,1568145316,99.897925,6.713112
ALABAMA_LAUDERDALE,1730146078,133608951,11901.79987,18,1863755029,92.831196,7.122725
ALABAMA_LAWRENCE,1788864251,68682382,14108.88251,21,1857546633,96.302522,6.976469
ALABAMA_LEE,1573514768,21526461,9368.819458,15,1595041229,98.650414,6.331326
ALABAMA_LIMESTONE,1450277886,122329712,11132.68036,17,1572607598,92.221218,7.101007
ALABAMA_LOWNDES,1854201377,23721835,13606.4978,22,1877923212,98.736805,6.263897
ALABAMA_MACON,1576855716,11345392,10583.16626,17,1588201108,99.285645,6.270183
ALABAMA_MADISON,2076111961,28810665,14662.40778,22,2104922626,98.631272,6.757219
ALABAMA_MARENGO,2530140237,14966620,18032.69623,29,2545106857,99.411945,6.254954
ALABAMA_MARION,1922657342,3183332,12836.37555,19,1925840674,99.834704,6.767173
ALABAMA_MARSHALL,1465531863,148495459,12964.72919,19,1614027322,90.799694,7.514939
ALABAMA_MOBILE,3184158350,1073926668,21132.23785,34,4258085018,74.779116,8.311631
ALABAMA_MONROE,2656469660,22609681,16928.65356,27,2679079341,99.156065,6.323236
ALABAMA_MONTGOMERY,2034017780,37744718,13076.03619,21,2071762498,98.178135,6.342231
ALABAMA_MORGAN,1501156832,50377239,10701.49213,16,1551534071,96.753069,6.912889
ALABAMA_PERRY,1863900621,10937769,12909.57733,21,1874838390,99.416602,6.183492
ALABAMA_PICKENS,2282674053,22740989,17691.75623,27,2305415042,99.013584,6.617781
ALABAMA_PIKE,1740647520,2336975,11110.61945,18,1742984495,99.865921,6.180854
ALABAMA_RANDOLPH,1503615937,9285420,10807.78491,16,1512901357,99.386251,6.79658
ALABAMA_RUSSELL,1660622936,15596319,10352.53021,17,1676219255,99.069554,6.146917
ALABAMA_SAINT CLAIR,1635786810,56407166,11998.06525,18,1692193976,96.666625,6.895443
ALABAMA_SHELBY,2034134905,62515663,14277.3465,22,2096650568,97.018308,6.689153
ALABAMA_SUMTER,2340898915,24634883,17108.14838,27,2365533798,98.958591,6.403033
ALABAMA_TALLADEGA,1908293036,60927931,13154.25153,20,1969220967,96.905988,6.78712
ALABAMA_TALLAPOOSA,1855782851,128806123,12801.27875,20,1984588974,93.509683,6.844895
ALABAMA_TUSCALOOSA,3421010003,78714550,24174.62207,37,3499724553,97.750836,6.684016
ALABAMA_WALKER,2048686078,36754696,16686.98743,25,2085440774,98.237557,6.794545
ALABAMA_WASHINGTON,2797720322,21652733,19389.43475,30,2819373055,99.232002,6.513166
ALABAMA_WILCOX,2301075085,49057525,15288.13208,25,2350132610,97.912564,6.245626
ALABAMA_WINSTON,1587614057,48917203,10076.77033,15,1636531260,97.010922,6.924836
ARIZONA_APACHE,29002035366,54153162,67108.94405,306,29056188528,99.813626,2.197198
ARIZONA_COCHISE,16083174724,17667961,28472.46695,168,16100842685,99.890267,1.696651
ARIZONA_COCONINO,48217246133,116631412,123390.049,513,48333877545,99.758696,2.411082
ARIZONA_GILA,12323152721,97113523,32620.89911,129,12420266244,99.218104,2.54868
ARIZONA_GRAHAM,11970605964,47476264,24252.83792,130,12018082228,99.60496,1.873002
ARIZONA_GREENLEE,4771123868,13750620,11988.03758,49,4784874488,99.712623,2.453589
ARIZONA_LAPAZ,11645512187,36551630,8058.20739,124,11682063817,99.687113,0.651895
ARIZONA_MARICOPA,23829622328,63347750,25657.70962,250,23892970078,99.734869,1.029037
ARIZONA_MOHAVE,34529358909,333447540,60917.88188,363,34862806449,99.043544,1.694385
ARIZONA_NAVAJO,25770517979,24125805,49240.70152,271,25794643784,99.90647,1.818701
ARIZONA_PIMA,23798597214,5112470,28715.13554,250,23803709684,99.978522,1.148852
ARIZONA_PINAL,13897997152,22344370,19210.94299,147,13920341522,99.839484,1.308968
ARIZONA_SANTA CRUZ,3201833002,3088479,7279.06015,33,3204921481,99.903633,2.207903
ARIZONA_YAVAPAI,21038727465,11501576,54126.16493,222,21050229041,99.945361,2.439448
ARIZONA_YUMA,14280777606,13248642,3582.873945,151,14294026248,99.907313,0.237497
ARKANSAS_ARKANSAS,2561013146,116378934,18275.36481,30,2677392080,95.653273,6.368615
ARKANSAS_ASHLEY,2396668938,39291076,13998.57867,23,2435960014,98.387039,6.186118
ARKANSAS_BAXTER,1435504137,84171720,8001.0495,14,1519675857,94.461206,6.05014
ARKANSAS_BENTON,2196053836,94223432,14821.84717,25,2290277268,95.885938,6.183116
ARKANSAS_BOONE,1528080514,31092205,9263.529236,16,1559172719,98.005852,5.90751
ARKANSAS_BRADLEY,1681512201,9535200,9872.206909,16,1691047401,99.436136,6.205118
ARKANSAS_CALHOUN,1627975429,9926146,9954.433167,16,1637901575,99.393972,6.259455
ARKANSAS_CARROLL,1631823636,22397554,9453.051147,16,1654221190,98.646036,5.989249
ARKANSAS_CHICOT,1669835058,119303631,12210.65125,20,1789138689,93.331784,6.541529
ARKANSAS_CLARK,2243130283,43387661,15361.33441,25,2286517944,98.102457,6.263384
ARKANSAS_CLAY,1656214474,5097734,8150.461914,14,1661312208,99.69315,5.839678
ARKANSAS_CLEBURNE,1434077953,98890719,9344.75293,16,1532968672,93.549071,6.243216
ARKANSAS_CLEVELAND,1548239710,2500196,9927.358643,16,1550739906,99.838774,6.214619
ARKANSAS_COLUMBIA,1983887989,1990757,13374.8595,22,1985878746,99.899754,6.085582
ARKANSAS_CONWAY,1430388148,37328675,8844.373779,15,1467716823,97.456684,6.050123
ARKANSAS_CRAIGHEAD,1831907088,14029461,12308.92151,21,1845936549,99.239981,5.90628
ARKANSAS_CRAWFORD,1537849721,28387848,8715.01709,15,1566237569,98.187513,5.917261
ARKANSAS_CRITTENDEN,1580882918,67433862,10475.87054,17,1648316780,95.908926,6.425134
ARKANSAS_CROSS,1596421810,15344835,9165.258484,15,1611766645,99.047949,6.168903
ARKANSAS_DALLAS,1728522507,1864048,10762.66083,17,1730386555,99.892276,6.337804
ARKANSAS_DESHA,1989461618,133085432,13375.86218,22,2122547050,93.729918,6.486656
ARKANSAS_DREW,2145488990,18914023,15310.19324,25,2164403013,99.126132,6.178065
ARKANSAS_FAULKNER,1678199700,41766665,10694.47266,17,1719966365,97.571658,6.447432
ARKANSAS_FRANKLIN,1576909749,27950884,9875.215027,17,1604860633,98.258361,5.911914
ARKANSAS_FULTON,1601099815,5526928,11486.65576,20,1606626743,99.655992,5.763154
ARKANSAS_GARLAND,1755025617,147393195,9544.30304,16,1902418812,92.252327,6.466167
ARKANSAS_GRANT,1636384327,2896901,12973.75427,20,1639281228,99.823282,6.498361
ARKANSAS_GREENE,1496205800,4789610,10411.69336,18,1500995410,99.680904,5.802791
ARKANSAS_HEMPSTEAD,1884271055,35369289,11039.42334,18,1919640344,98.157504,6.248135
ARKANSAS_HOT SPRING,1593594553,18034772,9298.625916,15,1611629325,98.88096,6.269239
ARKANSAS_HOWARD,1524380362,17475613,11259.02856,18,1541855975,98.866586,6.326724
ARKANSAS_INDEPENDENCE,1978814985,19593589,10954.18811,19,1998408574,99.01954,5.822449
ARKANSAS_IZARD,1503735021,8913817,10284.3418,18,1512648838,99.410715,5.747392
ARKANSAS_JACKSON,1641629489,19623387,10523.00049,18,1661252876,98.81876,5.915993
ARKANSAS_JEFFERSON,2253424970,113261151,14615.27802,23,2366686121,95.214357,6.673856
ARKANSAS_JOHNSON,1708980734,58598404,11523.75732,20,1767579138,96.684821,5.959445
ARKANSAS_LAFAYETTE,1368278171,43469432,8556.58075,14,1411747603,96.920878,6.306013
ARKANSAS_LAWRENCE,1521913730,12286149,8565.605225,15,1534199879,99.199182,5.756503
ARKANSAS_LEE,1560781755,43720909,11115.63336,18,1604502664,97.275111,6.348337
ARKANSAS_LINCOLN,1454383536,27514923,9236.454529,15,1481898459,98.143265,6.27413
ARKANSAS_LITTLE RIVER,1378511385,84225310,8750.11438,14,1462736695,94.241936,6.631954
ARKANSAS_LOGAN,1834415737,61409940,9978.498901,17,1895825677,96.760781,6.066203
ARKANSAS_LONOKE,1997848802,82750645,12429.25336,19,2080599447,96.02275,6.812669
ARKANSAS_MADISON,2160720581,7318310,12767.18549,22,2168038891,99.662446,5.822922
ARKANSAS_MARION,1546110609,112284588,9085.036987,16,1658395197,93.229323,6.090517
ARKANSAS_MILLER,1620637610,30875065,11072.51465,18,1651512675,98.130498,6.268588
ARKANSAS_MISSISSIPPI,2332481583,49826387,13823.0954,23,2382307970,97.908483,6.138428
ARKANSAS_MONROE,1572467982,36693587,10996.30469,18,1609161569,97.719708,6.251613
ARKANSAS_MONTGOMERY,2019984639,52914079,14795.77533,25,2072898718,97.447339,6.073342
ARKANSAS_NEVADA,1600206102,7241222,12821.33386,21,1607447324,99.54952,6.133025
ARKANSAS_NEWTON,2126132564,5930171,13717.80518,24,2132062735,99.721858,5.731694
ARKANSAS_OUACHITA,1897898727,18050436,11756.39911,19,1915949163,99.057885,6.246427
ARKANSAS_PERRY,1428530422,23226442,10701.492,18,1451756864,98.400115,6.041937
ARKANSAS_PHILLIPS,1801669169,82139041,13404.94275,22,1883808210,95.639734,6.370946
ARKANSAS_PIKE,1555611456,34977709,8440.260254,14,1590589165,97.800959,6.164313
ARKANSAS_POINSETT,1964149129,13520122,12631.81195,21,1977669251,99.316361,6.056554
ARKANSAS_POLK,2220863254,12372575,14960.22858,24,2233235829,99.44598,6.268155
ARKANSAS_POPE,2104407172,47240356,12107.36664,21,2151647528,97.804457,5.894836
ARKANSAS_PRAIRIE,1677973068,71807770,9942.399963,16,1749780838,95.896185,6.479924
ARKANSAS_PULASKI,1964339922,126230012,16561.64197,25,2090569934,93.961933,7.050362
ARKANSAS_RANDOLPH,1689251373,9889900,9871.203369,17,1699141273,99.417947,5.840586
ARKANSAS_SAINT FRANCIS,1644019105,20027489,11773.44629,19,1664046594,98.796459,6.272037
ARKANSAS_SALINE,1874047317,17969885,11539.80249,18,1892017202,99.050226,6.472475
ARKANSAS_SCOTT,2311217233,14870494,14434.78027,24,2326087727,99.360708,6.053189
ARKANSAS_SEARCY,1724955843,6256683,10718.53888,19,1731212526,99.638595,5.661798
ARKANSAS_SEBASTIAN,1375720610,37325387,9612.491394,16,1413045997,97.358516,6.170808
ARKANSAS_SEVIER,1464132101,41833257,8245.724304,13,1505965358,97.222163,6.524094
ARKANSAS_SHARP,1565401499,5201390,9706.750854,17,1570602889,99.668828,5.728826
ARKANSAS_STONE,1570754768,7842161,8552.569519,15,1578596929,99.50322,5.730179
ARKANSAS_UNION,2691655893,41400825,18555.13593,30,2733056718,98.485182,6.280179
ARKANSAS_VAN BUREN,1838244470,37694051,12085.30579,21,1875938521,97.990656,5.872915
ARKANSAS_WASHINGTON,2439709563,26898329,15142.73157,26,2466607892,98.909501,5.88834
ARKANSAS_WHITE,2680828175,18293048,18810.841,31,2699121223,99.322259,6.109419
ARKANSAS_WOODRUFF,1519769776,18703960,9768.922302,16,1538473736,98.784252,6.180718
ARKANSAS_YELL,2408958968,48394529,14044.70465,24,2457353497,98.030624,5.969523
CALIFORNIA_ALAMEDA,1909614756,216907015,11149.72693,19,2126521771,89.799916,6.534836
CALIFORNIA_ALPINE,1912292608,12557304,7993.027832,20,1924849912,99.347622,4.022758
CALIFORNIA_AMADOR,1539933596,29470567,9235.451385,17,1569404163,98.122181,5.536586
CALIFORNIA_BUTTE,4238488156,105261063,24872.54617,46,4343749219,97.576723,5.541358
CALIFORNIA_CALAVERAS,2641784992,43841871,14440.79709,28,2685626863,98.367537,5.243018
CALIFORNIA_COLUSA,2980332742,14608887,16904.58691,30,2994941629,99.512215,5.662483
CALIFORNIA_CONTRA COSTA,1857229826,225285866,9809.032471,17,2082515692,89.182033,6.469934
CALIFORNIA_DEL NORTE,2606117982,578742642,14991.31433,26,3184860624,81.828321,7.046326
CALIFORNIA_EL DORADO,4423299441,203342316,23960.0311,47,4626641757,95.60497,5.332232
CALIFORNIA_FRESNO,15432139300,136609898,58459.10672,163,15568749198,99.122538,3.618197
CALIFORNIA_GLENN,3403160291,33693350,19448.59781,36,3436853641,99.019645,5.455875
CALIFORNIA_HUMBOLDT,9241426488,1253864712,54756.90436,95,10495291200,88.053074,6.545921
CALIFORNIA_IMPERIAL,10814594615,790217372,2316.383652,113,11604811987,93.190606,0.219968
CALIFORNIA_INYO,26410680788,76915743,37463.24425,280,26487596531,99.709616,1.34187
CALIFORNIA_KERN,21062540828,78680980,67959.28754,224,21141221808,99.627831,3.04523
CALIFORNIA_KINGS,3600883803,3162664,11464.59494,37,3604046467,99.912247,3.101261
CALIFORNIA_LAKE,3254349190,188851723,19418.51508,37,3443200913,94.515228,5.552806
CALIFORNIA_LASSEN,11761615584,463426056,50319.67493,129,12225041640,96.209207,4.054446
CALIFORNIA_LOS ANGELES,10511861492,1793485467,45397.10877,108,12305346959,85.425153,4.920607
CALIFORNIA_MADERA,5534617472,42245931,20822.38388,56,5576863403,99.242479,3.746665
CALIFORNIA_MARIN,1347950152,797055812,6311.393524,12,2145005964,62.841324,8.369484
CALIFORNIA_MARIPOSA,3752472150,36225644,16966.75827,40,3788697794,99.04385,4.282638
CALIFORNIA_MENDOCINO,9081426663,962946206,47957.16357,92,10044372869,90.413078,5.765466
CALIFORNIA_MERCED,5014506620,110178168,24594.78037,55,5124684788,97.85005,4.570032
CALIFORNIA_MODOC,10225096402,661284408,44638.01718,115,10886380810,93.925581,4.132598
CALIFORNIA_MONO,7896838483,214695677,25365.9054,89,8111534160,97.353205,2.927589
CALIFORNIA_MONTEREY,8499616876,1267800137,46920.30658,88,9767417013,87.020108,6.127151
CALIFORNIA_NAPA,1937986794,104295181,13143.22034,23,2042281975,94.893204,6.021974
CALIFORNIA_NEVADA,2480587338,41531993,12932.64053,26,2522119331,98.35329,5.057373
CALIFORNIA_ORANGE,2053367783,401931862,6823.805634,20,2455299645,83.630028,4.079758
CALIFORNIA_PLACER,3644306246,246466620,20187.63495,39,3890772866,93.665356,5.526394
CALIFORNIA_PLUMAS,6612400910,156387636,30238.33331,71,6768788546,97.689577,4.359646
CALIFORNIA_RIVERSIDE,18671212657,243883196,26331.56651,197,18915095853,98.710643,1.354087
CALIFORNIA_SACRAMENTO,2499983887,75425434,15269.07947,26,2575409321,97.071322,6.049905
CALIFORNIA_SAN BENITO,3596591082,4719300,19552.88547,38,3601310382,99.868956,5.152248
CALIFORNIA_SAN BERNARDINO,51975576263,96414425,79870.11276,550,52071990688,99.814844,1.454878
CALIFORNIA_SAN DIEGO,10904373558,817404622,24425.31314,115,11721778180,93.026616,2.283153
CALIFORNIA_SAN FRANCISCO,121477743,479114582,544.293038,0.986896,600592325,20.226323,27.267433
CALIFORNIA_SAN JOAQUIN,3606127799,89109687,20832.41202,38,3695237486,97.588526,5.617683
CALIFORNIA_SAN LUIS OBISPO,8548557892,815573121,45105.30466,90,9364131013,91.290456,5.489841
CALIFORNIA_SAN MATEO,1161957020,757114175,5940.371033,10,1919071195,60.547885,9.81103
CALIFORNIA_SANTA BARBARA,7084063392,2729751706,36742.25662,67,9813815098,72.184602,7.60547
CALIFORNIA_SANTA CLARA,3343890934,33595384,22798.83069,38,3377486318,99.005314,6.05997
CALIFORNIA_SANTA CRUZ,1152794691,419743117,6654.338501,11,1572537808,73.307916,8.25204
CALIFORNIA_SHASTA,9778407493,186302040,45799.21701,106,9964709533,98.130382,4.403
CALIFORNIA_SIERRA,2468694583,23299110,11819.57346,27,2491993693,99.065041,4.418935
CALIFORNIA_SISKIYOU,16261933244,179149815,78102.2403,173,16441083059,98.910353,4.564315
CALIFORNIA_SOLANO,2128488719,218671901,13046.95587,22,2347160620,90.683556,6.539702
CALIFORNIA_SONOMA,4080764059,498182342,21367.88718,41,4578946401,89.120153,5.847925
CALIFORNIA_STANISLAUS,3874667416,46351766,20218.72052,40,3921019182,98.817864,5.115148
CALIFORNIA_SUTTER,1560546528,15240591,10042.67639,17,1575787119,99.032827,5.96515
CALIFORNIA_TEHAMA,7638228749,33767783,38550.23966,81,7671996532,99.559857,4.780329
CALIFORNIA_TRINITY,8234265082,73407950,44334.17975,86,8307673032,99.116384,5.201095
CALIFORNIA_TULARE,12494889125,37207487,39928.03653,133,12532096612,99.703102,3.011048
CALIFORNIA_TUOLUMNE,5752029633,138772442,26821.91809,63,5890802075,97.644252,4.360162
CALIFORNIA_VENTURA,4771987962,947345370,22835.93295,49,5719333332,83.436087,5.585586
CALIFORNIA_YOLO,2628144759,22878428,17631.59064,30,2651023187,99.136996,5.928359
CALIFORNIA_YUBA,1636913845,31057995,9430.990753,17,1667971840,98.137978,5.6529
COLORADO_ADAMS,3020716474,44323330,14769.70358,33,3065039804,98.553907,4.54134
COLORADO_ALAMOSA,1871465874,1847610,4828.306274,23,1873313484,99.901372,2.101336
COLORADO_ARAPAHOE,2066706152,19421685,10201.11295,22,2086127837,99.069008,4.680444
COLORADO_ARCHULETA,3496712109,13740247,14509.98779,36,3510452356,99.60859,4.04639
COLORADO_BACA,6617400568,6142192,26918.18332,70,6623542760,99.907267,3.849024
COLORADO_BENT,3918255147,73141518,13236.47809,44,3991396665,98.167521,3.064446
COLORADO_BOULDER,1881309466,36493405,9474.109436,20,1917802871,98.097124,4.828944
COLORADO_BROOMFIELD,85478765,1411396,422.338835,0.915799,86890161,98.375655,4.687852
COLORADO_CHAFFEE,2624715697,3999975,12456.32806,27,2628715672,99.847835,4.620486
COLORADO_CHEYENNE,4605713960,8166129,20997.86774,49,4613880089,99.82301,4.292877
COLORADO_CLEAR CREEK,1023234039,3274908,5260.497284,11,1026508947,99.680966,4.797576
COLORADO_CONEJOS,3334423894,9235012,10777.70221,36,3343658906,99.723805,3.002098
COLORADO_COSTILLA,3179452298,8828906,10581.16057,34,3188281204,99.723083,3.120748
COLORADO_CROWLEY,2039427872,33422981,6556.06781,21,2072850853,98.387584,3.173101
COLORADO_CUSTER,1913031921,3364150,8254.749084,23,1916396071,99.824454,3.595333
COLORADO_DELTA,2958090985,16786780,9950.421921,32,2974877765,99.435715,3.127153
COLORADO_DENVER,397024773,4245401,1408.882721,3,401270174,98.942009,4.746493
COLORADO_DOLORES,2763958510,2716141,8612.735641,28,2766674651,99.901827,3.079
COLORADO_DOUGLAS,2176240583,6798120,11189.83786,23,2183038703,99.688594,4.880345
COLORADO_EAGLE,4362757834,18967056,24197.68585,48,4381724890,99.567133,5.063101
COLORADO_EL PASO,5508514019,7087627,25062.0679,57,5515601646,99.871499,4.402949
COLORADO_ELBERT,4793643980,442147,24530.60336,53,4794086127,99.990777,4.632809
COLORADO_FREMONT,3970664378,2235542,17016.89664,40,3972899920,99.94373,4.256619
COLORADO_GARFIELD,7633795354,21708518,35389.5293,82,7655503872,99.716433,4.328069
COLORADO_GILPIN,388556733,942056,1909.261688,4,389498789,99.758136,4.784727
COLORADO_GRAND,4782273598,59889262,26683.53659,54,4842162860,98.763171,5.003278
COLORADO_GUNNISON,8389338078,53067068,43964.15964,92,8442405146,99.371422,4.808941
COLORADO_HINSDALE,2893614473,15324685,14694.49619,32,2908939158,99.473186,4.61635
COLORADO_HUERFANO,4120756304,5792101,13407.95049,43,4126548405,99.859638,3.122511
COLORADO_JACKSON,4179530230,18750017,22576.21719,46,4198280247,99.553388,4.929891
COLORADO_JEFFERSON,1979623397,25204513,10077.77307,21,2004827910,98.742809,4.86004
COLORADO_KIOWA,4578603586,47032918,19334.28287,49,4625636504,98.983212,3.986304
COLORADO_KIT CARSON,5596501939,2251929,25084.12891,57,5598753868,99.959778,4.402495
COLORADO_LA PLATA,4376255148,25642578,15798.5389,45,4401897726,99.417465,3.531358
COLORADO_LAKE,976215867,18111565,5728.787811,12,994327432,98.178511,4.862561
COLORADO_LARIMER,6723025059,99007869,32592.82169,72,6822032928,98.548704,4.593445
COLORADO_LAS ANIMAS,12361852579,6929970,39169.94759,131,12368782549,99.943972,2.991749
COLORADO_LINCOLN,6676158660,22780358,31859.8017,71,6698939018,99.659941,4.502608
COLORADO_LOGAN,4761947979,16363553,23737.41751,52,4778311532,99.657545,4.580574
COLORADO_MESA,8621849401,31490395,25486.23685,89,8653339796,99.63609,2.874081
COLORADO_MINERAL,2268209075,5222161,9728.811462,22,2273431236,99.770296,4.432368
COLORADO_MOFFAT,12284943819,19803411,51688.44724,129,12304747230,99.839059,4.013315
COLORADO_MONTEZUMA,5255990025,27208195,12601.7287,57,5283198220,99.485005,2.222274
COLORADO_MONTROSE,5804023558,4923260,16635.84628,61,5808946818,99.915247,2.729501
COLORADO_MORGAN,3316441486,34663098,15442.55783,35,3351104584,98.965622,4.458275
COLORADO_OTERO,3268424427,20092434,8676.91243,34,3288516861,99.389012,2.567722
COLORADO_OURAY,1402719363,1599543,5988.50354,14,1404318906,99.886098,4.28238
COLORADO_PARK,5682182508,43519840,27960.05469,57,5725702348,99.239921,4.942842
COLORADO_PHILLIPS,1781724976,301808,8628.779877,19,1782026784,99.983064,4.542232
COLORADO_PITKIN,2514104907,6472577,13261.54697,26,2520577484,99.743211,5.113727
COLORADO_PROWERS,4243429484,15345176,16630.83255,43,4258774660,99.639681,3.881622
COLORADO_PUEBLO,6179964847,30219283,18501.98926,64,6210184130,99.513392,2.905072
COLORADO_RIO BLANCO,8342275014,4868111,35154.88237,88,8347143125,99.941679,3.997204
COLORADO_RIO GRANDE,2361956092,984295,7373.319901,24,2362940387,99.958344,3.073497
COLORADO_ROUTT,6117602807,15831744,30966.33917,60,6133434551,99.741878,5.174413
COLORADO_SAGUACHE,8206547705,4454510,29862.29712,85,8211002215,99.945749,3.515118
COLORADO_SAN JUAN,1003660672,2035929,4657.836395,10,1005696601,99.79756,4.667285
COLORADO_SAN MIGUEL,3332606082,5204095,12558.60997,37,3337810177,99.844087,3.399519
COLORADO_SEDGWICK,1419419016,3530746,6095.799194,14,1422949762,99.751871,4.364973
COLORADO_SUMMIT,1575590637,28283537,8552.569702,18,1603874174,98.236549,4.836721
COLORADO_TELLER,1442732301,4946547,7831.582916,16,1447678848,99.658312,4.911521
COLORADO_WASHINGTON,6521806798,15207401,32263.91531,68,6537014199,99.767365,4.755757
COLORADO_WELD,10320918528,82403821,47165.98325,109,10403322349,99.207909,4.361703
COLORADO_YUMA,6123763561,11134665,30204.23929,67,6134898226,99.818503,4.516292
CONNECTICUT_FAIRFIELD,1618659464,549285481,9701.736877,15,2167944945,74.66331,8.662654
CONNECTICUT_HARTFORD,1903543898,40543777,13901.31055,22,1944087675,97.914509,6.453362
CONNECTICUT_LITCHFIELD,2384120288,62342856,16027.1687,25,2446463144,97.451715,6.578507
CONNECTICUT_MIDDLESEX,956493754,180679140,7598.941895,12,1137172894,84.111551,7.528635
CONNECTICUT_NEW HAVEN,1565683007,667074958,8816.296814,14,2232757965,70.123275,8.980406
CONNECTICUT_NEW LONDON,1722711022,276663467,10919.09149,17,1999374489,86.162499,7.454513
CONNECTICUT_TOLLAND,1062807466,17549693,6325.432129,10,1080357159,98.375566,6.429881
CONNECTICUT_WINDHAM,1328478482,21477921,9560.347412,15,1349956403,98.408992,6.476608
DELAWARE_KENT,1517888728,549776901,9135.175354,14,2067665629,73.410744,8.888515
DELAWARE_NEW CASTLE,1104157957,175368158,7670.138123,12,1279526115,86.294288,7.406342
DELAWARE_SUSSEX,2424573396,674146105,15850.68243,24,3098719501,78.244365,8.440801
FLORIDA_ALACHUA,2267634813,241567998,15773.46985,28,2509202811,90.372719,6.231767
FLORIDA_BAKER,1515738968,9686120,10570.13062,18,1525425088,99.365022,5.909821
FLORIDA_BAY,1964743641,711110042,9817.054932,16,2675853683,73.424928,8.356371
FLORIDA_BRADFORD,761362115,16905201,4028.100952,7,778267316,97.827841,5.882201
FLORIDA_BREVARD,2628793422,1403880653,17498.22321,24,4032674075,65.187351,11.184572
FLORIDA_BROWARD,3115289087,310801098,37711.92798,32,3426090185,90.928403,12.960722
FLORIDA_CALHOUN,1469394565,18070425,9897.275879,16,1487464990,98.785153,6.26187
FLORIDA_CHARLOTTE,1764058559,458736680,18621.31799,19,2222795239,79.362171,12.349327
FLORIDA_CITRUS,1507142302,495547944,9424.974182,17,2002690246,75.255887,7.367002
FLORIDA_CLAY,1565946418,100824283,10534.03076,18,1666770701,93.950921,6.229039
FLORIDA_COLLIER,5172045734,797817705,52102.58887,52,5969863439,86.635914,11.565329
FLORIDA_COLUMBIA,2065648366,9755972,12615.76801,22,2075404338,99.529924,5.761524
FLORIDA_DESOTO,1649027549,6243548,16986.8136,18,1655271097,99.622808,9.472849
FLORIDA_DIXIE,1826222177,410621177,10364.56348,18,2236843354,81.642828,7.052782
FLORIDA_DUVAL,1975200913,403608266,11972.99634,20,2378809179,83.03318,7.209766
FLORIDA_ESCAMBIA,1701552902,563919214,11512.72748,19,2265472116,75.108093,8.06748
FLORIDA_FLAGLER,1256519820,221918896,6561.081177,11,1478438716,84.989645,7.018054
FLORIDA_FRANKLIN,1411908392,1275539662,7347.248413,12,2687448054,52.537142,11.654054
FLORIDA_GADSDEN,1337233845,31646697,9323.695007,15,1368880542,97.688133,6.362898
FLORIDA_GILCHRIST,905705573,14362143,5127.129333,9,920067716,98.439012,5.787147
FLORIDA_GLADES,2089001842,466834350,25321.78363,24,2555836192,81.734575,12.908544
FLORIDA_GULF,1433401108,494650564,9825.076843,16,1928051672,74.344538,8.25975
FLORIDA_HAMILTON,1330689567,13659798,7711.251404,13,1344349365,98.98391,5.992622
FLORIDA_HARDEE,1651311553,1457910,13580.42609,17,1652769463,99.91179,7.995539
FLORIDA_HENDRY,2994619266,87037213,36279.98236,34,3081656479,97.175635,10.980719
FLORIDA_HERNANDO,1224962206,300591492,7718.270569,14,1525553698,80.296237,6.865889
FLORIDA_HIGHLANDS,2635685460,230708988,26359.64398,29,2866394448,91.951248,9.885165
FLORIDA_HILLSBOROUGH,2646772012,631505816,18621.31818,28,3278277828,80.73666,8.237238
FLORIDA_HOLMES,1240232912,26393538,6662.360596,11,1266626450,97.916233,6.185585
FLORIDA_INDIAN RIVER,1302203837,295578902,14211.16455,14,1597782739,81.500682,12.454904
FLORIDA_JACKSON,2378066187,94242663,15339.27332,25,2472308850,96.188071,6.378867
FLORIDA_JEFFERSON,1549012954,99610823,11107.61151,18,1648623777,93.957941,6.567721
FLORIDA_LAFAYETTE,1407256297,11817999,8315.917786,14,1419074296,99.167204,5.989824
FLORIDA_LAKE,2462450874,534024151,17263.57568,31,2996475025,82.178255,6.776605
FLORIDA_LEE,2023963480,1116067200,18419.76263,19,3140030680,64.456806,15.040478
FLORIDA_LEON,1727237331,90397079,10543.05554,17,1817634410,95.026663,6.526376
FLORIDA_LEVY,2896183010,762935040,17292.65686,31,3659118050,79.149756,7.047749
FLORIDA_LIBERTY,2164099094,19582444,14246.26099,23,2183681538,99.103237,6.250075
FLORIDA_MADISON,1804001484,49634046,11154.74109,18,1853635530,97.322341,6.36758
FLORIDA_MANATEE,1925994820,386168924,16883.52911,20,2312163744,83.298375,10.134369
FLORIDA_MARION,4113978836,192297049,24413.28009,43,4306275885,95.534493,5.942887
FLORIDA_MARTIN,1408486860,542095986,16549.60815,14,1950582846,72.208513,16.370852
FLORIDA_MIAMI-DADE,4920565755,1376144237,56051.47083,52,6296709992,78.145028,13.793749
FLORIDA_MONROE,2546034512,7133349995,22543.12537,22,9679384507,26.303682,38.956049
FLORIDA_NASSAU,1680074659,200051074,10202.11572,17,1880125733,89.359697,6.715829
FLORIDA_OKALOOSA,2409272023,393297372,13803.03961,23,2802569395,85.966543,6.980997
FLORIDA_OKEECHOBEE,1992107752,317943020,22273.38226,22,2310050772,86.236535,11.740111
FLORIDA_ORANGE,2335820971,262462219,14989.30896,27,2598283190,89.898629,6.175396
FLORIDA_OSCEOLA,3438372945,462245351,26095.91748,40,3900618296,88.149434,7.401045
FLORIDA_PALM BEACH,5087468869,1084901519,67504.03381,55,6172370388,82.42326,14.890773
FLORIDA_PASCO,1933633890,315641629,10779.70734,19,2249275519,85.966965,6.599663
FLORIDA_PINELLAS,709079114,865966111,4273.778381,7,1575045225,45.019603,13.683618
FLORIDA_POLK,4655603728,551339930,34089.94666,56,5206943658,89.411448,6.808402
FLORIDA_PUTNAM,1885167063,256548276,12857.43311,22,2141715339,88.021364,6.631294
FLORIDA_SAINT JOHNS,1555456032,572308820,9565.360962,16,2127764852,73.102816,8.178003
FLORIDA_SAINT LUCIE,1480568023,300932235,16980.79688,15,1781500258,83.107932,13.621481
FLORIDA_SANTA ROSA,2622050628,418020790,16369.11145,27,3040071418,86.249639,7.02917
FLORIDA_SARASOTA,1439998180,438480422,14745.63721,16,1878478602,76.657683,12.022309
FLORIDA_SEMINOLE,801150340,93274757,6134.907043,11,894425097,89.571541,6.226518
FLORIDA_SUMTER,1442966763,58774363,10036.65955,18,1501741126,96.086252,5.803038
FLORIDA_SUWANNEE,1783342112,9593307,11170.7854,19,1792935419,99.464939,5.910988
FLORIDA_TAYLOR,2702180425,489194882,18186.11884,30,3191375307,84.671346,7.159494
FLORIDA_UNION,630804540,16049423,4547.532227,8,646853963,97.518849,5.829043
FLORIDA_VOLUSIA,2852204344,857791723,16770.21661,29,3709996067,76.878905,7.522003
FLORIDA_WAKULLA,1570615733,334902363,11108.6142,18,1905518096,82.424603,7.487391
FLORIDA_WALTON,2687740188,522795160,19761.46045,33,3210535348,83.716262,7.153116
FLORIDA_WASHINGTON,1514305977,81008176,9753.880493,16,1595314153,94.922118,6.422292
GEORGIA_APPLING,1316423275,10328007,7955.925659,13,1326751282,99.221557,6.167957
GEORGIA_ATKINSON,887636792,4701677,4875.43634,8,892338469,99.473106,6.126576
GEORGIA_BACON,735776603,4499926,5377.820801,9,740276529,99.392129,6.011901
GEORGIA_BAKER,885665383,18598654,4890.4776,8,904264037,97.943228,6.24147
GEORGIA_BALDWIN,670027542,24802965,5088.022034,8,694830507,96.430358,6.595462
GEORGIA_BANKS,601022383,4593262,3236.920593,5,605615645,99.241555,6.523317
GEORGIA_BARROW,417082276,4909657,3206.837646,5,421991933,98.836552,6.489173
GEORGIA_BARTOW,1188568909,27370203,9574.386108,14,1215939112,97.749048,6.996331
GEORGIA_BEN HILL,647812569,9803929,5135.151917,8,657616498,98.509172,6.516083
GEORGIA_BERRIEN,1174237672,11673014,8175.531128,13,1185910686,99.015692,6.351387
GEORGIA_BIBB,645938978,14264344,3712.23053,6,660203322,97.839401,6.32368
GEORGIA_BLECKLEY,559106469,8441079,4411.156677,7,567547548,98.51271,6.396791
GEORGIA_BRANTLEY,1147949245,10297607,7129.648682,12,1158246852,99.110932,5.994671
GEORGIA_BROOKS,1277341272,11955761,8145.448059,13,1289297033,99.072691,6.324376
GEORGIA_BRYAN,1133242924,43792586,7782.447388,13,1177035510,96.279417,6.217838
GEORGIA_BULLOCH,1750705245,32857751,11543.81305,19,1783562996,98.157747,6.189721
GEORGIA_BURKE,2142010451,20584267,11821.57904,19,2162594718,99.048168,6.281675
GEORGIA_BUTTS,475754783,11269640,4383.079407,7,487024423,97.686022,6.409865
GEORGIA_CALHOUN,726191502,8271470,4892.482666,8,734462972,98.873807,6.185261
GEORGIA_CAMDEN,1632512482,392476019,8997.796753,15,2024988501,80.618358,7.440652
GEORGIA_CANDLER,629520839,15018189,4343.971558,7,644539028,97.669933,6.35372
GEORGIA_CARROLL,1292475864,12301430,9512.214661,14,1304777294,99.057201,6.859107
GEORGIA_CATOOSA,419998844,771159,2005.526978,3,420770003,99.816727,6.697364
GEORGIA_CHARLTON,2020415647,5963237,13088.06909,22,2026378884,99.70572,5.966681
GEORGIA_CHATHAM,1121767063,509858591,4753.098633,8,1631625654,68.751497,8.641809
GEORGIA_CHATTAHOOCHEE,644226248,6276670,4193.557007,7,650502918,99.035105,6.049164
GEORGIA_CHATTOOGA,811512394,570806,6164.990112,9,812083200,99.929711,6.854807
GEORGIA_CHEROKEE,1090600986,34467305,7479.613098,11,1125068291,96.936426,7.014544
GEORGIA_CLARKE,308784925,4688311,2533.983459,4,313473236,98.504398,6.431143
GEORGIA_CLAY,506093883,56546975,3662.092163,6,562640858,89.949721,6.785443
GEORGIA_CLAYTON,366946710,6972579,3240.93158,5,373919289,98.135272,6.605029
GEORGIA_CLINCH,2110829176,23303279,13062.99988,22,2134132455,98.908068,6.003279
GEORGIA_COBB,880052398,12376345,6698.460144,10,892428743,98.613184,6.792662
GEORGIA_COFFEE,1533928847,26927255,9214.39386,15,1560856102,98.274841,6.250765
GEORGIA_COLQUITT,1416818776,24869747,8198.594604,13,1441688523,98.274957,6.417313
GEORGIA_COLUMBIA,751293211,45394065,5200.331543,8,796687276,94.302148,6.893178
GEORGIA_COOK,591606618,12386236,5058.941895,8,603992854,97.949274,6.456074
GEORGIA_COWETA,1142012458,12689156,7258.002014,11,1154701614,98.901088,6.671498
GEORGIA_CRAWFORD,841521988,3988980,5461.049805,9,845510968,99.528217,6.096596
GEORGIA_CRISP,706236812,21409235,4457.283752,7,727646047,97.05774,6.560577
GEORGIA_DADE,450605307,467844,2676.375732,4,451073151,99.896282,6.697886
GEORGIA_DAWSON,546042257,9272655,3402.376526,5,555314912,98.330199,6.920308
GEORGIA_DE KALB,1546667779,67329698,11715.28607,19,1613997477,95.828389,6.821137
GEORGIA_DECATUR,693420786,8881087,4575.60968,7,702301873,98.735432,6.244911
GEORGIA_DODGE,1284521385,18545752,8939.636536,14,1303067137,98.576762,6.477647
GEORGIA_DOOLY,1016908653,12141885,6891.99353,11,1029050538,98.820089,6.340258
GEORGIA_DOUGHERTY,851183463,15352849,6184.042664,10,866536312,98.228251,6.295585
GEORGIA_DOUGLAS,518355038,2423527,4015.065125,6,520778565,99.534634,6.723062
GEORGIA_EARLY,1327626601,9702715,9782.960144,16,1337329316,99.274471,6.159036
GEORGIA_ECHOLS,1088849470,809587,8908.550781,15,1089659057,99.925703,5.94345
GEORGIA_EFFINGHAM,1240134674,10579329,9024.871582,15,1250714003,99.154137,6.067907
GEORGIA_ELBERT,909338653,59876817,5893.241028,9,969215470,93.822136,6.979212
GEORGIA_EMANUEL,1762672232,24896323,11452.56171,18,1787568555,98.607252,6.4524
GEORGIA_EVANS,473694908,10295112,2432.704285,4,483990020,97.872867,6.213939
GEORGIA_FANNIN,1002597261,13473582,7547.800781,11,1016070843,98.673953,6.953848
GEORGIA_FAYETTE,503436770,12808490,3899.747192,6,516245260,97.518914,6.664942
GEORGIA_FLOYD,1320434485,22384089,9634.551819,14,1342818574,98.333052,6.998484
GEORGIA_FORSYTH,581585514,58452875,4678.89447,7,640038389,90.867286,7.355931
GEORGIA_FRANKLIN,677441264,12732865,5242.447449,8,690174129,98.155123,6.676228
GEORGIA_FULTON,1364208323,19715145,9283.58429,14,1383923468,98.575417,6.726963
GEORGIA_GILMER,1103886891,12283371,7597.939148,11,1116170262,98.899507,6.984077
GEORGIA_GLASCOCK,372299245,1832723,2644.287292,4,374131968,99.51014,6.643261
GEORGIA_GLYNN,1086632090,429152790,3614.962402,6,1515784880,71.687751,8.404417
GEORGIA_GORDON,923182326,5729532,5484.113525,8,928911858,99.3832,6.897687
GEORGIA_GRADY,1177153102,14924993,8046.174316,13,1192078095,98.747985,6.267839
GEORGIA_GREENE,1004043243,48038460,7095.554443,11,1052081703,95.433961,6.759128
GEORGIA_GWINNETT,1115308546,15958551,7867.682434,12,1131267097,98.589321,6.650215
GEORGIA_HABERSHAM,716980220,5802042,6059.699951,9,722782262,99.197263,6.787486
GEORGIA_HALL,1017862667,94017443,7277.054504,11,1111880110,91.544282,7.226562
GEORGIA_HANCOCK,1220058037,17479744,7182.794922,11,1237537781,98.587539,6.623366
GEORGIA_HARALSON,730804591,2616531,5508.17981,8,733421122,99.643243,6.909876
GEORGIA_HARRIS,1201300628,23651059,7445.518921,12,1224951687,98.069225,6.326754
GEORGIA_HART,601970613,63521436,3952.893738,6,665492049,90.454967,7.283355
GEORGIA_HEARD,766564615,13266481,6011.5672,9,779831096,98.298801,6.795118
GEORGIA_HENRY,825296435,20290464,5095.041321,8,845586899,97.600428,6.525383
GEORGIA_HOUSTON,973947729,9996585,6237.189026,10,983944314,98.984029,6.301207
GEORGIA_IRWIN,917795232,21756147,6429.719482,10,939551379,97.684411,6.582135
GEORGIA_JACKSON,879737593,8885451,6352.506836,10,888623044,99.000088,6.416668
GEORGIA_JASPER,954167633,13100766,5675.641479,9,967268399,98.645591,6.392854
GEORGIA_JEFF DAVIS,857073381,11603478,5575.365112,9,868676859,98.664235,6.278719
GEORGIA_JEFFERSON,1363760603,8070350,10449.79828,16,1371830953,99.41171,6.569773
GEORGIA_JENKINS,899567385,13334498,6201.089661,10,912901883,98.539328,6.29301
GEORGIA_JOHNSON,784815227,9256634,5162.226318,8,794071861,98.834283,6.528891
GEORGIA_JONES,1020304148,3820256,6872.94104,11,1024124404,99.626973,6.271523
GEORGIA_LAMAR,475264443,6044329,3074.472839,5,481308772,98.744189,6.227147
GEORGIA_LANIER,509026287,8423356,3060.434143,5,517449643,98.37214,6.222156
GEORGIA_LAURENS,2090974815,28853699,14026.65625,22,2119828514,98.638866,6.463733
GEORGIA_LEE,921731012,15310683,6800.742126,11,937041695,98.366062,6.285189
GEORGIA_LIBERTY,1337652378,222886509,7187.808716,12,1560538887,85.717337,6.987899
GEORGIA_LINCOLN,544884786,121513274,3975.957214,6,666398060,81.765662,8.104374
GEORGIA_LONG,1037013527,8855056,6050.675049,10,1045868583,99.15333,6.102342
GEORGIA_LOWNDES,1287636223,34747915,7433.48584,12,1322384138,97.372328,6.361737
GEORGIA_LUMPKIN,732817525,3278613,6129.893372,9,736096138,99.554594,6.841465
GEORGIA_MACON,1037709939,13841916,6037.639221,10,1051551855,98.683668,6.118175
GEORGIA_MADISON,731225616,8461936,4470.319702,7,739687552,98.856012,6.460073
GEORGIA_MARION,947979449,3790127,5919.312866,10,951769576,99.601781,5.942979
GEORGIA_MCDUFFIE,666848710,23114025,4629.758972,7,689962735,96.64996,6.843191
GEORGIA_MCINTOSH,1117201951,369176400,5993.517578,10,1486378351,75.16269,7.974059
GEORGIA_MERIWETHER,1298162536,10832501,10149.97223,16,1308995037,99.172457,6.396668
GEORGIA_MILLER,731471786,3211332,4900.505432,8,734683118,99.562896,6.152525
GEORGIA_MITCHELL,1326483091,4314212,8658.862793,14,1330797303,99.675817,6.205018
GEORGIA_MONROE,1025872449,5643845,6769.656372,11,1031516294,99.452859,6.188091
GEORGIA_MONTGOMERY,624563060,9191488,3149.680115,5,633754548,98.549677,6.392066
GEORGIA_MORGAN,899770619,18692749,5072.980713,8,918463368,97.96478,6.472965
GEORGIA_MURRAY,892235146,5719644,6797.733643,10,897954790,99.363037,6.84131
GEORGIA_MUSCOGEE,560678533,11737090,3033.359741,5,572415623,97.949551,6.193719
GEORGIA_NEWTON,709140711,13978612,4442.242371,7,723119323,98.066901,6.471154
GEORGIA_OCONEE,477424988,5283000,2533.983521,4,482707988,98.905549,6.405059
GEORGIA_OGLETHORPE,1137166303,7707062,7734.314758,12,1144873365,99.32682,6.488945
GEORGIA_PAULDING,808928487,5212751,5456.036133,8,814141238,99.359724,6.863994
GEORGIA_PEACH,389234752,2678497,3060.434204,5,391913249,99.316559,6.162989
GEORGIA_PICKENS,601031022,1690669,4825.298096,7,602721691,99.719494,6.912673
GEORGIA_PIERCE,881760420,7200741,5341.720703,9,888961161,99.189982,5.983714
GEORGIA_PIKE,559660466,8595984,4991.756653,8,568256450,98.487306,6.335533
GEORGIA_POLK,803758612,4681735,4835.325378,7,808440347,99.420893,6.947843
GEORGIA_PULASKI,645583957,5046606,4456.28125,7,650630563,99.224352,6.415881
GEORGIA_PUTNAM,892721781,41451859,6978.231201,11,934173640,95.562724,6.638411
GEORGIA_QUITMAN,391703076,24158295,2422.676636,4,415861371,94.190782,6.430238
GEORGIA_RABUN,958658531,17839291,7677.157471,11,976497822,98.173136,7.109108
GEORGIA_RANDOLPH,1109126228,6830041,7905.78717,13,1115956269,99.387965,6.118824
GEORGIA_RICHMOND,840016006,11014326,5671.630493,9,851030332,98.705766,6.371799
GEORGIA_ROCKDALE,336228288,5902795,2562.060852,4,342131083,98.274698,6.5176
GEORGIA_SCHLEY,432291200,2369649,2381.563354,4,434660849,99.454828,5.986545
GEORGIA_SCREVEN,1672540367,26152057,10244.23175,17,1698692424,98.46046,6.120242
GEORGIA_SEMINOLE,615215134,49261828,4292.830505,7,664476962,92.586375,6.623669
GEORGIA_SPALDING,507620135,9374579,3171.740967,5,516994714,98.186717,6.460631
GEORGIA_STEPHENS,463996899,13074870,3325.163757,5,477071769,97.259349,6.837726
GEORGIA_STEWART,1188153055,12598484,6613.225464,11,1200751539,98.950783,6.075771
GEORGIA_SUMTER,1250646284,25211441,7284.074219,12,1275857725,98.023961,6.192427
GEORGIA_TALBOT,1013662781,8766848,7234.938416,12,1022429629,99.142548,6.081259
GEORGIA_TALIAFERRO,504031037,1915743,3950.888062,6,505946780,99.621355,6.609841
GEORGIA_TATTNALL,1245327267,19489654,7988.01416,13,1264816921,98.459093,6.240791
GEORGIA_TAYLOR,975613091,7801539,7143.686646,12,983414630,99.206689,6.000676
GEORGIA_TELFAIR,1132621096,17356399,8224.666443,13,1149977495,98.490718,6.423617
GEORGIA_TERRELL,869559691,5087422,4849.364502,8,874647113,99.418346,6.09717
GEORGIA_THOMAS,1410566922,19671369,9359.794556,15,1430238291,98.624609,6.326882
GEORGIA_TIFT,675699704,20460911,5166.237305,8,696160615,97.060892,6.653346
GEORGIA_TOOMBS,942778662,18086323,8143.442322,13,960864985,98.117704,6.384359
GEORGIA_TOWNS,431139631,13792631,3472.569946,5,444932262,96.90006,7.167323
GEORGIA_TREUTLEN,516529390,7805618,3835.570557,6,524335008,98.51133,6.489221
GEORGIA_TROUP,1072274471,82761542,7107.587646,11,1155036013,92.834722,6.960158
GEORGIA_TURNER,739222162,11823691,4520.457764,7,751045853,98.425703,6.561088
GEORGIA_TWIGGS,930478091,8740237,5634.528137,9,939218328,99.069414,6.319394
GEORGIA_UNION,834197337,18082752,6209.111572,9,852280089,97.878309,7.048562
GEORGIA_UPSON,837774874,10585407,3661.089478,6,848360281,98.752251,6.178913
GEORGIA_WALKER,1156145280,1672676,8770.169434,13,1157817956,99.855532,6.756044
GEORGIA_WALTON,846447052,8248719,5737.812866,9,854695771,99.034894,6.437476
GEORGIA_WARE,2328980907,22695018,13520.25971,23,2351675925,99.034943,5.935656
GEORGIA_WARREN,736483608,6034478,6627.263977,10,742518086,99.187295,6.681565
GEORGIA_WASHINGTON,1757341877,15131098,12413.20935,19,1772472975,99.146328,6.589521
GEORGIA_WAYNE,1662608486,17768247,11473.61981,19,1680376733,98.942603,6.103283
GEORGIA_WEBSTER,542230981,2348162,4184.532227,7,544579143,99.568812,6.003791
GEORGIA_WHEELER,765314383,12377032,5036.881042,8,777691415,98.408491,6.397925
GEORGIA_WHITE,623522401,3919460,4081.247498,6,627441861,99.375327,6.844837
GEORGIA_WHITFIELD,752230670,1597015,6750.603821,10,753827685,99.788146,6.764936
GEORGIA_WILCOX,978525378,11147628,5813.019836,9,989673006,98.873605,6.532493
GEORGIA_WILKES,1216001409,11896927,8580.647339,13,1227898336,99.031115,6.665075
GEORGIA_WILKINSON,1163459874,7084800,8266.782227,13,1170544674,99.394743,6.397786
GEORGIA_WORTH,1478137689,10471700,10167.01923,16,1488609389,99.296545,6.399404
IDAHO_ADA,2724700350,22164062,8191.575378,28,2746864412,99.193114,2.949361
IDAHO_ADAMS,3529648933,17359846,17047.98212,38,3547008779,99.510578,4.508376
IDAHO_BANNOCK,2881339307,92073211,9285.590042,31,2973412518,96.90345,3.091068
IDAHO_BEAR LAKE,2527123158,191364280,9404.918701,28,2718487438,92.960634,3.613249
IDAHO_BENEWAH,2012242918,18803193,11251.00644,22,2031046111,99.074211,5.161882
IDAHO_BINGHAM,5422897822,68476532,15339.27325,57,5491374354,98.753017,2.725082
IDAHO_BLAINE,6831708301,44657946,20421.27815,73,6876366247,99.350559,2.815722
IDAHO_BOISE,4919826443,19104286,20731.13248,55,4938930729,99.61319,3.783933
IDAHO_BONNER,4489055950,478884838,25190.42175,50,4967940788,90.360496,5.575539
IDAHO_BONNEVILLE,4832872006,88855960,16972.7746,52,4921727966,98.194619,3.324006
IDAHO_BOUNDARY,3285863793,24278857,16292.90125,33,3310142650,99.266531,4.973724
IDAHO_BUTTE,5792473996,5259978,17367.86342,63,5797733974,99.909275,2.759307
IDAHO_CAMAS,2782253889,11548054,8449.285034,29,2793801943,99.586655,2.92564
IDAHO_CANYON,1520445185,43124146,4705.969269,16,1563569331,97.241942,3.024652
IDAHO_CARIBOU,4569240762,89216879,16138.47549,48,4658457641,98.084841,3.427831
IDAHO_CASSIA,6644897847,39158605,17163.29997,67,6684056452,99.414149,2.576783
IDAHO_CLARK,4566524478,2476453,16298.91779,49,4569000931,99.945799,3.328114
IDAHO_CLEARWATER,6364412866,79592493,35639.21732,69,6444005359,98.76486,5.229698
IDAHO_CUSTER,12748378763,42527191,47790.70541,134,12790905954,99.66752,3.578368
IDAHO_ELMORE,7964417370,68330393,23802.59732,83,8032747763,99.149352,2.892387
IDAHO_FRANKLIN,1717211132,12153472,6238.191772,18,1729364604,99.297229,3.49019
IDAHO_FREMONT,4827633123,83440650,19375.39639,51,4911073773,98.300969,3.864761
IDAHO_GEM,1449796187,12491929,5769.901245,16,1462288116,99.145727,3.63726
IDAHO_GOODING,1888932880,12472392,4495.388763,19,1901405272,99.344043,2.381616
IDAHO_IDAHO,21956620022,67533572,112152.0775,227,22024153594,99.693366,4.956871
IDAHO_JEFFERSON,2832617272,31168374,8793.232727,30,2863785646,98.911637,2.963329
IDAHO_JEROME,1547443957,13094559,3976.959915,16,1560538516,99.160895,2.506633
IDAHO_KOOTENAI,3205833848,184447574,18532.07205,36,3390281422,94.55952,5.443976
IDAHO_LATAH,2786483015,2369979,13742.87366,28,2788852994,99.91502,4.912344
IDAHO_LEMHI,11819910390,14109812,43185.01279,125,11834020202,99.880769,3.458925
IDAHO_LEWIS,1240141959,2340247,6583.142273,13,1242482206,99.811647,5.073512
IDAHO_LINCOLN,3111517528,11588562,8044.168777,34,3123106090,99.628941,2.374744
IDAHO_MADISON,1215396310,10500895,4214.614929,13,1225897205,99.143411,3.270022
IDAHO_MINIDOKA,1960610400,13928520,4681.902817,20,1974538920,99.294594,2.357582
IDAHO_NEZ PERCE,2197139822,21252906,11358.30209,24,2218392728,99.041968,4.778405
IDAHO_ONEIDA,3105269253,3995237,9756.888931,32,3109264490,99.871505,3.052951
IDAHO_OWYHEE,19860561638,74125617,50170.26335,211,19934687255,99.628158,2.386612
IDAHO_PAYETTE,1053846155,8875236,3310.122345,10,1062721391,99.164858,3.337999
IDAHO_POWER,3635892388,99205466,9883.23703,41,3735097854,97.343966,2.476317
IDAHO_SHOSHONE,6830898569,13962455,39405.59705,74,6844861024,99.796016,5.335965
IDAHO_TETON,1163139972,2868473,4589.648651,12,1166008445,99.753992,3.834139
IDAHO_TWIN FALLS,4977200216,18076679,13587.44521,55,4995276895,99.638125,2.479417
IDAHO_VALLEY,9492607317,177116417,45894.47971,103,9669723734,98.16834,4.538912
IDAHO_WASHINGTON,3762870369,53228012,15705.28195,40,3816098381,98.605172,3.981861
ILLINOIS_ADAMS,2214804481,41776031,15425.5108,23,2256580512,98.148702,6.833248
ILLINOIS_ALEXANDER,609667772,44539209,4929.58551,8,654206981,93.191878,6.612145
ILLINOIS_BOND,985073265,6462629,7597.939087,11,991535894,99.34822,6.952533
ILLINOIS_BOONE,727180620,3363818,5428.961548,8,730544438,99.539546,6.817594
ILLINOIS_BROWN,791828628,4144346,6050.674927,9,795972974,99.479336,6.758159
ILLINOIS_BUREAU,2250935503,11472955,14761.68127,22,2262408458,99.492888,6.744055
ILLINOIS_CALHOUN,657422422,77044161,5337.710022,8,734466583,89.510188,7.454054
ILLINOIS_CARROLL,1153597403,55881824,8986.766541,13,1209479227,95.379679,7.247767
ILLINOIS_CASS,973198204,20569928,6877.954956,10,993768132,97.930108,7.02333
ILLINOIS_CHAMPAIGN,2579920046,6088510,18012.64056,27,2586008556,99.76456,6.687092
ILLINOIS_CHRISTIAN,1837569692,16227345,10946.16663,16,1853797037,99.124643,6.901769
ILLINOIS_CLARK,1298554908,8771353,7755.372864,12,1307326261,99.329062,6.506465
ILLINOIS_CLAY,1212815740,3271820,8073.24884,12,1216087560,99.730955,6.745857
ILLINOIS_CLINTON,1227502416,75634004,9498.175842,14,1303136420,94.196003,7.202441
ILLINOIS_COLES,1316447134,4621015,8621.760376,13,1321068149,99.650206,6.655404
ILLINOIS_COOK,2447357982,1786325586,17166.30817,27,4233683568,57.806823,10.998515
ILLINOIS_CRAWFORD,1149031255,5744821,9261.523376,14,1154776076,99.502516,6.648449
ILLINOIS_CUMBERLAND,895989980,2538006,8000.046997,12,898527986,99.717537,6.689095
ILLINOIS_DE KALB,1029678329,19492326,7460.560364,11,1049170655,98.142121,6.78326
ILLINOIS_DE WITT,1635154165,8561738,11983.02387,18,1643715903,99.479123,6.81784
ILLINOIS_DOUGLAS,1079110176,1448702,6647.319092,10,1080558878,99.86593,6.656243
ILLINOIS_DU PAGE,848891774,22352081,5119.107727,8,871243855,97.434463,6.567373
ILLINOIS_EDGAR,1614400675,1565052,12246.75061,19,1615965727,99.903151,6.451907
ILLINOIS_EDWARDS,576012469,781202,4759.11554,7,576793671,99.864561,6.807957
ILLINOIS_EFFINGHAM,1240007567,3172833,9414.946533,14,1243180400,99.744781,6.742169
ILLINOIS_FAYETTE,1855567160,22931323,11560.86047,17,1878498483,98.779274,6.884548
ILLINOIS_FORD,1257690128,1640595,9314.670105,14,1259330723,99.869725,6.662015
ILLINOIS_FRANKLIN,1059101590,58404682,7248.977112,11,1117506272,94.77366,6.953387
ILLINOIS_FULTON,2242134871,43972444,17256.55682,25,2286107315,98.076536,7.037996
ILLINOIS_GALLATIN,836540704,13265237,6150.951477,10,849805941,98.439028,6.248489
ILLINOIS_GREENE,1406464906,8423898,8831.338074,13,1414888804,99.404625,6.834025
ILLINOIS_GRUNDY,1082940535,32131734,6558.073364,10,1115072269,97.118417,6.752657
ILLINOIS_HAMILTON,1125731579,3172088,7900.77356,12,1128903667,99.719012,6.60253
ILLINOIS_HANCOCK,2055798692,53563370,16282.87384,24,2109362062,97.460684,6.9613
ILLINOIS_HARDIN,459435085,10641306,3022.329163,5,470076391,97.73626,6.184663
ILLINOIS_HENDERSON,981077355,42557372,7637.046814,11,1023634727,95.842524,7.243935
ILLINOIS_HENRY,2131698418,6825690,15055.49097,22,2138524108,99.680822,6.865318
ILLINOIS_IROQUOIS,2894039691,4241183,19351.33008,30,2898280874,99.853666,6.459896
ILLINOIS_JACKSON,1511439610,48312227,11345.26624,18,1559751837,96.90257,6.504395
ILLINOIS_JASPER,1281043656,9334509,8073.249023,12,1290378165,99.276607,6.769025
ILLINOIS_JEFFERSON,1479412106,32628685,10929.11926,16,1512040791,97.842076,6.981352
ILLINOIS_JERSEY,957415147,20333975,7465.574219,11,977749122,97.920328,6.931028
ILLINOIS_JO DAVIESS,1556385345,45789933,9842.123718,14,1602175278,97.142015,7.236918
ILLINOIS_JOHNSON,890268816,12819263,6128.890625,10,903088079,98.580508,6.217142
ILLINOIS_KANE,1345136016,12488621,8527.500732,13,1357624637,99.080112,6.620517
ILLINOIS_KANKAKEE,1752114613,12445712,12820.33136,20,1764560325,99.294685,6.455699
ILLINOIS_KENDALL,829412768,5136525,6506.93219,10,834549293,99.384515,6.547229
ILLINOIS_KNOX,1855427715,8837382,13898.30237,20,1864265097,99.525959,6.98225
ILLINOIS_LA SALLE,1149695575,2394258736,7998.041748,12,3543954311,32.441038,20.509508
ILLINOIS_LAKE,2940070811,33698037,20625.84204,31,2973768848,98.866824,6.741427
ILLINOIS_LAWRENCE,963938131,5076516,5418.93396,8,969014647,99.476116,6.809341
ILLINOIS_LEE,1877189067,9732924,14870.98291,22,1886921991,99.48419,6.794585
ILLINOIS_LIVINGSTON,2702983877,5975818,18692.51428,28,2708959695,99.779405,6.690657
ILLINOIS_LOGAN,1600757857,2252736,12924.61865,19,1603010593,99.859468,6.812004
ILLINOIS_MACON,1503684109,13406663,10896.02808,16,1517090772,99.116291,6.870735
ILLINOIS_MACOUPIN,2235091594,12250027,16385.15552,24,2247341621,99.45491,6.864566
ILLINOIS_MADISON,1853152211,63999231,13046.95612,19,1917151442,96.661754,7.103967
ILLINOIS_MARION,1482865607,9234118,10949.17468,16,1492099725,99.381133,6.885848
ILLINOIS_MARSHALL,1001843226,30364348,6744.587341,10,1032207574,97.05831,6.949006
ILLINOIS_MASON,1396914851,62748513,12312.93311,18,1459663364,95.701165,7.14779
ILLINOIS_MASSAC,614453457,11901753,4235.673035,7,626355210,98.09984,6.168167
ILLINOIS_MCDONOUGH,1526339596,2012552,10965.21893,16,1528352148,99.868319,6.862298
ILLINOIS_MCHENRY,1562786765,19872668,10729.5694,16,1582659433,98.74435,6.792599
ILLINOIS_MCLEAN,3064600918,7801224,19639.12286,29,3072402142,99.746087,6.78935
ILLINOIS_MENARD,814269350,2640418,5489.127319,8,816909768,99.67678,6.883659
ILLINOIS_MERCER,1453604361,19411909,11858.68134,17,1473016270,98.682166,7.068851
ILLINOIS_MONROE,997988611,33757480,7133.659485,11,1031746091,96.728121,6.704508
ILLINOIS_MONTGOMERY,1822726466,15458338,14373.61194,21,1838184804,99.159043,6.902625
ILLINOIS_MORGAN,1473584099,9065256,10317.43372,15,1482649355,99.388577,6.920603
ILLINOIS_MOULTRIE,870134336,22104308,6085.77179,9,892238644,97.522601,6.933745
ILLINOIS_OGLE,1964903717,12378959,13692.73554,20,1977282676,99.373941,6.8895
ILLINOIS_PEORIA,1602464183,30659935,11629.04828,17,1633124118,98.122621,6.971498
ILLINOIS_PERRY,1144367942,13418384,8359.036499,13,1157786326,98.841031,6.505424
ILLINOIS_PIATT,1137492084,754122,10161.00232,15,1138246206,99.933747,6.778493
ILLINOIS_PIKE,2153190725,45251516,16144.49219,24,2198442241,97.941655,6.868244
ILLINOIS_POPE,955326683,14329536,4849.364258,8,969656219,98.522204,6.152629
ILLINOIS_PULASKI,516225217,10490502,3673.122681,6,526715719,98.008318,6.246277
ILLINOIS_PUTNAM,414649309,31195045,3357.252197,5,445844354,93.003154,7.219652
ILLINOIS_RANDOLPH,1490194115,56150225,8848.385254,14,1546344340,96.368841,6.558422
ILLINOIS_RICHLAND,932484096,4874777,6146.940308,9,937358873,99.479945,6.865639
ILLINOIS_ROCK ISLAND,1107097990,61745666,9003.813416,13,1168843656,94.717372,7.312292
ILLINOIS_SAINT CLAIR,1703443126,41955024,11252.00928,17,1745398150,97.596249,6.781848
ILLINOIS_SALINE,984170285,17979016,7488.637756,12,1002149301,98.205954,6.354535
ILLINOIS_SANGAMON,2248804592,22646083,17178.34094,25,2271450675,99.003012,6.940533
ILLINOIS_SCHUYLER,1132602885,10510632,9505.19519,14,1143113517,99.080526,6.852431
ILLINOIS_SCOTT,649542040,4814546,4771.148682,7,654356586,99.264232,6.866448
ILLINOIS_SHELBY,1964532713,24746071,14273.33575,21,1989278784,98.756028,6.882442
ILLINOIS_STARK,746156170,684784,5429.964417,8,746840954,99.908309,6.793685
ILLINOIS_STEPHENSON,1461392067,1350223,13948.44025,20,1462742290,99.907692,6.980664
ILLINOIS_TAZEWELL,1674335551,29823809,10873.96735,16,1704159360,98.24994,6.917286
ILLINOIS_UNION,1070730011,22541668,7462.56604,12,1093271679,97.938146,6.349727
ILLINOIS_VERMILION,2326634941,7531159,16123.43427,25,2334166100,99.677351,6.47025
ILLINOIS_WABASH,578403998,10973558,4123.363586,6,589377556,98.138111,7.002654
ILLINOIS_WARREN,1404768322,1672625,10451.80408,15,1406440947,99.881074,6.976166
ILLINOIS_WASHINGTON,1457093517,3412705,9297.62323,14,1460506222,99.766334,6.656714
ILLINOIS_WAYNE,1848810372,4224962,13539.31287,20,1853035334,99.771998,6.785127
ILLINOIS_WHITE,1281999214,17833682,9675.6651,15,1299832896,98.628002,6.540174
ILLINOIS_WHITESIDE,1771808919,31883752,11587.935,17,1803692671,98.232307,6.939094
ILLINOIS_WILL,2164895527,34582450,14591.21191,23,2199477977,98.427697,6.445346
ILLINOIS_WILLIAMSON,1088349246,62460141,6896.0047,11,1150809387,94.572503,6.628877
ILLINOIS_WINNEBAGO,1329068433,15598347,9597.449341,14,1344666780,98.839984,6.935777
ILLINOIS_WOODFORD,1366821840,38477370,10159.99982,15,1405299210,97.26198,6.964009
INDIANA_ADAMS,877815499,2693924,5800.986572,9,880509423,99.694049,6.465321
INDIANA_ALLEN,1702451597,7002354,12851.41669,20,1709453951,99.590375,6.452138
INDIANA_BARTHOLOMEW,1054009620,6674332,7415.436035,12,1060683952,99.370752,6.218661
INDIANA_BENTON,1052616465,236033,7681.168274,12,1052852498,99.977582,6.402409
INDIANA_BLACKFORD,427559407,1298757,2576.099243,4,428858164,99.697159,6.459811
INDIANA_BOONE,1095336920,877155,7387.358826,12,1096214075,99.919983,6.161062
INDIANA_BROWN,808043860,12025993,4387.090454,7,820069853,98.53354,6.360547
INDIANA_CARROLL,964057405,7236323,6747.595398,11,971293728,99.254981,6.180221
INDIANA_CASS,1067476817,6973614,8017.094482,13,1074450431,99.35096,6.207284
INDIANA_CLARK,965645927,9224853,6089.782776,10,974870780,99.053736,6.147959
INDIANA_CLAY,926186141,7041856,6989.26178,11,933227997,99.24543,6.402183
INDIANA_CLINTON,1049119213,461117,6124.879456,10,1049580330,99.956067,6.127572
INDIANA_CRAWFORD,791534792,8041751,5659.597229,9,799576543,98.994249,6.35233
INDIANA_DAVIESS,1112396613,19102189,6413.675537,10,1131498802,98.31178,6.523812
INDIANA_DE KALB,790171242,5995931,5248.464111,8,796167173,99.2469,6.492654
INDIANA_DEARBORN,964946132,1955432,5641.547546,9,966901564,99.797763,6.573875
INDIANA_DECATUR,939731962,2657419,6443.757935,10,942389381,99.718013,6.286112
INDIANA_DELAWARE,1015536276,9863733,8374.07782,13,1025400009,99.03806,6.504164
INDIANA_DUBOIS,1106611849,20897444,8213.635925,13,1127509293,98.146583,6.437495
INDIANA_ELKHART,1199603973,12434083,8860.418396,14,1212038056,98.974118,6.39447
INDIANA_FAYETTE,556901555,366408,3911.780396,6,557267963,99.934249,6.523924
INDIANA_FLOYD,383227470,2706389,2425.684814,4,385933859,99.298743,6.107038
INDIANA_FOUNTAIN,1024774345,5729004,7031.37793,11,1030503349,99.444058,6.427897
INDIANA_FRANKLIN,995658324,17155849,5935.357117,9,1012814173,98.306121,6.708475
INDIANA_FULTON,954133353,7439336,5594.417664,9,961572689,99.226337,6.264486
INDIANA_GIBSON,1262416968,30412007,8720.031372,13,1292828975,97.647639,6.869307
INDIANA_GRANT,1072484468,2101804,7660.110535,12,1074586272,99.804408,6.395935
INDIANA_GREENE,1404983917,8919619,10270.30377,16,1413903536,99.369149,6.459691
INDIANA_HAMILTON,1021354950,20951834,5591.409363,9,1042306784,97.989859,6.340122
INDIANA_HANCOCK,792423987,2767313,3771.393677,6,795191300,99.651994,6.307607
INDIANA_HARRISON,1254889463,5193186,7877.709961,13,1260082649,99.587869,6.084854
INDIANA_HENDRICKS,1053849390,4880796,6195.072754,10,1058730186,99.538995,6.223765
INDIANA_HENRY,1014963816,7646214,5808.006042,9,1022610030,99.252284,6.501956
INDIANA_HOWARD,759058571,2194576,6197.078552,10,761253147,99.711715,6.214995
INDIANA_HUNTINGTON,991056705,13133694,7026.363892,11,1004190399,98.692111,6.472253
INDIANA_JACKSON,1320827167,10183339,9478.120605,15,1331010506,99.234917,6.367463
INDIANA_JASPER,1449563753,4428654,10849.90149,17,1453992407,99.695414,6.401794
INDIANA_JAY,994310119,458556,7760.386536,12,994768675,99.953903,6.469971
INDIANA_JEFFERSON,934051509,5826447,6185.04541,10,939877956,99.380085,6.223627
INDIANA_JENNINGS,975382328,4528272,6197.078369,10,979910600,99.537889,6.225849
INDIANA_JOHNSON,829945881,3488796,5524.224426,9,833434677,99.581395,6.163829
INDIANA_KNOX,1336486449,20782636,9188.321838,14,1357269085,98.46879,6.665144
INDIANA_KOSCIUSKO,1376412110,59459183,7517.718079,12,1435871293,95.859017,6.535395
INDIANA_LA PORTE,983236292,18318591,5754.859863,9,1001554883,98.170985,6.391848
INDIANA_LAGRANGE,1291857838,331164016,9418.957642,15,1623021854,79.595838,8.033446
INDIANA_LAKE,1549512632,38822025,10667.39832,17,1588334657,97.555803,6.436629
INDIANA_LAWRENCE,1163367162,7122899,9856.162354,15,1170490061,99.39146,6.611006
INDIANA_MADISON,1170467555,2549371,7606.963806,12,1173016926,99.782665,6.352944
INDIANA_MARION,1027109536,16681706,8649.838074,14,1043791242,98.401816,6.278803
INDIANA_MARSHALL,1148969980,15858580,7537.773254,12,1164828560,98.638548,6.368177
INDIANA_MARTIN,869615712,12033245,6485.874207,10,881648957,98.635143,6.575622
INDIANA_MIAMI,968246954,9184624,5599.431519,9,977431578,99.060331,6.280608
INDIANA_MONROE,1021806936,43510632,7042.40802,11,1065317568,95.915713,6.674807
INDIANA_MONTGOMERY,1307030254,2067987,9420.963135,15,1309098241,99.84203,6.290579
INDIANA_MORGAN,1045940869,14473934,6203.095215,10,1060414803,98.635069,6.288935
INDIANA_NEWTON,1040539828,4349506,6411.669861,10,1044889334,99.583735,6.438471
INDIANA_NOBLE,1064081178,17064798,7614.986145,12,1081145976,98.421601,6.44759
INDIANA_OHIO,223126823,3352210,1291.559326,2,226479033,98.519859,6.554817
INDIANA_ORANGE,1031794491,25417740,5842.099976,9,1057212231,97.595777,6.65113
INDIANA_OWEN,997911601,6566400,6330.446045,10,1004478001,99.346287,6.372101
INDIANA_PARKE,1151822270,13655202,8964.705994,14,1165477472,98.82836,6.479275
INDIANA_PERRY,988702362,11783935,6096.802124,10,1000486297,98.822179,6.169467
INDIANA_PIKE,865839128,17591094,6423.703003,10,883430222,98.008774,6.551794
INDIANA_PORTER,1082833138,268632882,6926.087585,11,1351466020,80.122853,7.858486
INDIANA_POSEY,1060259608,25787556,7097.560059,11,1086047164,97.625558,6.60926
INDIANA_PULASKI,1123212810,2224813,7522.731995,12,1125437623,99.802316,6.282778
INDIANA_PUTNAM,1244585894,5585892,6956.170532,11,1250171786,99.55319,6.352174
INDIANA_RANDOLPH,1171656774,2420288,6514.954407,10,1174077062,99.793856,6.528412
INDIANA_RIPLEY,1156231106,4243112,8275.80719,13,1160474218,99.634364,6.389367
INDIANA_RUSH,1057035401,872270,7013.32782,11,1057907671,99.917548,6.381014
INDIANA_SAINT JOSEPH,1185940302,9042850,7589.917053,12,1194983152,99.243265,6.373159
INDIANA_SCOTT,493136550,6078495,2462.787231,4,499215045,98.782389,6.23286
INDIANA_SHELBY,1064843786,4190385,8069.237915,13,1069034171,99.608021,6.231532
INDIANA_SPENCER,1027623726,12065860,6114.851807,10,1039689586,98.839475,6.186649
INDIANA_STARKE,800679810,7929143,5661.602722,9,808608953,99.019409,6.353388
INDIANA_STEUBEN,799729298,35454787,5798.981018,9,835184085,95.754854,6.728967
INDIANA_SULLIVAN,1158170859,17983718,7027.366699,11,1176154577,98.470973,6.487714
INDIANA_SWITZERLAND,571525793,7177694,3822.534607,6,578703487,98.759694,6.450902
INDIANA_TIPPECANOE,1292163432,11230872,8757.133667,14,1303394304,99.138337,6.309462
INDIANA_TIPTON,674797609,68028,4349.988098,7,674865637,99.98992,6.214895
INDIANA_UNION,417480644,10326434,3985.984863,6,427807078,97.586194,6.807631
INDIANA_VANDERBURGH,605216607,7666148,3874.678162,6,612882755,98.749166,6.539596
INDIANA_VERMILLION,665275343,7895064,3854.622803,6,673170407,98.827182,6.500612
INDIANA_VIGO,1045190744,17870822,7638.049866,12,1063061566,98.318929,6.473872
INDIANA_WABASH,1068468089,21854115,7534.764893,12,1090322204,97.995628,6.407399
INDIANA_WARREN,944543945,4442743,5750.848999,9,948986688,99.531843,6.419887
INDIANA_WARRICK,996664711,16155579,7553.817322,12,1012820290,98.404892,6.38739
INDIANA_WASHINGTON,1330454436,7530005,9488.14801,15,1337984441,99.437213,6.361232
INDIANA_WAYNE,1040539262,6701983,7865.676941,12,1047241245,99.360034,6.596949
INDIANA_WELLS,953341278,5596377,5791.961548,9,958937655,99.416398,6.473291
INDIANA_WHITE,1308306951,9166124,8156.478271,13,1317473075,99.304265,6.318172
INDIANA_WHITLEY,869152583,6041913,6321.421204,10,875194496,99.309649,6.365365
IOWA_ADAIR,1474404191,2597996,10643.33154,16,1477002187,99.824103,6.663804
IOWA_ADAMS,1096686238,5367875,8020.102478,12,1102054113,99.512921,6.716132
IOWA_ALLAMAKEE,1655115644,51094070,11156.74677,16,1706209714,97.005405,7.188225
IOWA_APPANOOSE,1287978861,49088024,10713.52515,16,1337066885,96.328679,6.951152
IOWA_AUDUBON,1147264566,1152260,9408.929993,14,1148416826,99.899665,6.727414
IOWA_BENTON,1854696286,5857893,13306.67163,19,1860554179,99.685153,7.025631
IOWA_BLACK HAWK,1465331241,17900676,11074.5202,16,1483231917,98.79313,7.00613
IOWA_BOONE,1480329000,5358730,10763.66339,16,1485687730,99.63931,6.751642
IOWA_BREMER,1127885584,10166467,8299.873474,12,1138052051,99.106678,6.978905
IOWA_BUCHANAN,1479090265,5219494,11213.90411,16,1484309759,99.648355,7.033423
IOWA_BUENA VISTA,1488981859,13798139,10382.61316,16,1502779998,99.081826,6.549267
IOWA_BUTLER,1502550830,4194983,10984.27173,16,1506745813,99.721587,6.884337
IOWA_CALHOUN,1475894599,5873827,10639.32068,16,1481768426,99.603593,6.67604
IOWA_CARROLL,1474835095,2145349,10571.13287,16,1476980444,99.854748,6.616569
IOWA_CASS,1461422458,1787165,8851.393372,13,1463209623,99.87786,6.817091
IOWA_CEDAR,1500798712,6385832,9897.275452,14,1507184544,99.576307,7.099563
IOWA_CERRO GORDO,1471889958,17659667,10780.71033,16,1489549625,98.814429,6.818785
IOWA_CHEROKEE,1494181147,423160,10199.10754,16,1494604307,99.971687,6.376247
IOWA_CHICKASAW,1306192609,3455451,11069.50659,16,1309648060,99.736154,6.936744
IOWA_CLARKE,1116716166,1524746,8006.063721,12,1118240912,99.863648,6.680829
IOWA_CLAY,1469139463,13866648,10617.25989,16,1483006111,99.064964,6.69842
IOWA_CLAYTON,2016295997,36695615,14070.77728,20,2052991612,98.212578,7.163429
IOWA_CLINTON,1799818625,39526969,14627.3114,21,1839345594,97.851031,7.118358
IOWA_CRAWFORD,1849742863,2194269,13023.89221,20,1851937132,99.881515,6.519671
IOWA_DALLAS,1523741177,8511951,10639.3208,16,1532253128,99.444481,6.686721
IOWA_DAVIS,1300661911,6904085,8719.028564,13,1307565996,99.47199,6.742546
IOWA_DECATUR,1377567269,4140764,10792.74353,16,1381708033,99.700316,6.765741
IOWA_DELAWARE,1496189232,3189562,11319.19415,16,1499378794,99.787274,7.089578
IOWA_DES MOINES,1077768387,35342795,8340.986755,12,1113111182,96.824864,7.178758
IOWA_DICKINSON,985542270,60712924,5374.812378,8,1046255194,94.197121,7.1324
IOWA_DUBUQUE,1575487988,21138781,12015.11224,17,1596626769,98.676035,7.162543
IOWA_EMMET,1025349330,17175565,5347.737732,8,1042524895,98.352503,6.796647
IOWA_FAYETTE,1892840956,1320706,14001.58667,20,1894161662,99.930275,7.005678
IOWA_FLOYD,1296550076,2023929,9644.579773,14,1298574005,99.844142,6.899739
IOWA_FRANKLIN,1507301289,1428853,10701.49219,16,1508730142,99.905294,6.694773
IOWA_FREMONT,1323915763,14171394,11828.59833,17,1338087157,98.940921,7.032478
IOWA_GREENE,1475303196,4255702,10738.59418,16,1479558898,99.712367,6.730982
IOWA_GRUNDY,1299797800,94406,9638.562927,14,1299892206,99.992737,6.885188
IOWA_GUTHRIE,1529698818,6355533,10683.4422,16,1536054351,99.586243,6.704893
IOWA_HAMILTON,1493784356,1965341,10750.62738,16,1495749697,99.868605,6.727982
IOWA_HANCOCK,1478895050,5265568,10696.47833,16,1484160618,99.645216,6.709102
IOWA_HARDIN,1474505068,1776735,8763.15033,13,1476281803,99.879648,6.749007
IOWA_HARRISON,1804814770,12411273,17752.92505,25,1817226043,99.317021,7.150003
IOWA_HENRY,1124799047,5775966,8270.793396,12,1130575013,99.489113,6.927721
IOWA_HOWARD,1225702842,931478,8283.829346,12,1226634320,99.924062,6.908437
IOWA_HUMBOLDT,1125014815,3376515,8010.07489,12,1128391330,99.700767,6.695096
IOWA_IDA,1117599852,1406462,7517.71814,12,1119006314,99.874312,6.272649
IOWA_IOWA,1518911694,2686847,11152.73554,16,1521598541,99.823419,6.98279
IOWA_JACKSON,1647344934,35129033,12654.87524,18,1682473967,97.912061,7.180409
IOWA_JASPER,1891760880,6578379,13757.91516,20,1898339259,99.653467,6.902878
IOWA_JEFFERSON,1127999808,3524817,8115.364929,12,1131524625,99.68849,6.783937
IOWA_JOHNSON,1587640014,26086670,11998.06506,17,1613726684,98.383452,7.173651
IOWA_JONES,1490844765,3782494,12075.27795,17,1494627259,99.746927,7.121126
IOWA_KEOKUK,1500071923,1928964,10935.13599,16,1502000887,99.871574,6.843249
IOWA_KOSSUTH,2519361795,4125592,16624.81598,25,2523487387,99.836512,6.660816
IOWA_LEE,1340448547,55266762,9534.275391,14,1395715309,96.040255,7.090981
IOWA_LINN,1857223982,19659622,13479.14697,19,1876883604,98.952539,7.169384
IOWA_LOUISA,1040584001,40784331,7680.165649,11,1081368332,96.228452,7.255618
IOWA_LUCAS,1115257644,9852833,8011.077454,12,1125110477,99.124279,6.734877
IOWA_LYON,1522007136,334399,6578.128601,10,1522341535,99.978034,6.579574
IOWA_MADISON,1452999207,2983840,10594.19629,16,1455983047,99.795064,6.63497
IOWA_MAHASKA,1478517367,6575294,11008.33771,16,1485092661,99.557247,6.910809
IOWA_MARION,1436120669,41487003,10843.88452,16,1477607672,97.192286,6.973216
IOWA_MARSHALL,1482776062,1803080,11093.57263,16,1484579142,99.878546,6.941914
IOWA_MILLS,1132942922,8313907,7134.662109,10,1141256829,99.271513,7.187019
IOWA_MITCHELL,1215049038,1118415,9627.531982,14,1216167453,99.908038,6.883138
IOWA_MONONA,1797637888,12592243,13365.83478,20,1810230131,99.304384,6.72973
IOWA_MONROE,1123320774,1522790,8101.326416,12,1124843564,99.864622,6.760257
IOWA_MONTGOMERY,1098405773,2410443,6164.989929,9,1100816216,99.781031,6.865021
IOWA_MUSCATINE,1132977157,30262371,8415.191345,12,1163239528,97.39844,7.199971
IOWA_O BRIEN,1484154177,447448,10476.8728,16,1484601625,99.969861,6.55002
IOWA_OSCEOLA,1032593811,1835263,5323.671448,8,1034429074,99.822582,6.666417
IOWA_PAGE,1385497539,1359120,9339.739441,14,1386856659,99.902,6.677787
IOWA_PALO ALTO,1460400549,14428727,10629.29297,16,1474829276,99.021668,6.708944
IOWA_PLYMOUTH,2234715215,2176851,14189.10327,22,2236892066,99.902684,6.455875
IOWA_POCAHONTAS,1495047191,3666530,10596.20184,16,1498713721,99.755355,6.638868
IOWA_POLK,1482025679,50041527,10648.34558,16,1532067206,96.733725,6.879934
IOWA_POTTAWATTAMIE,2461811904,22350013,15851.68536,22,2484161917,99.1003,7.270726
IOWA_POWESHIEK,1514945159,2961947,11182.81842,16,1517907106,99.804866,7.002927
IOWA_RINGGOLD,1386932363,8723128,10716.53363,16,1395655491,99.37498,6.73996
IOWA_SAC,1489300198,8569439,10296.37555,16,1497869637,99.427892,6.472263
IOWA_SCOTT,1186437845,26222213,8334.970337,12,1212660058,97.837629,7.099322
IOWA_SHELBY,1530110542,1486125,12331.98547,18,1531596667,99.902969,6.857757
IOWA_SIOUX,1988888285,2795018,13014.86731,20,1991683303,99.859666,6.516579
IOWA_STORY,1482881240,2863675,10825.8349,16,1485744915,99.807257,6.779213
IOWA_TAMA,1867410516,2769418,12600.72614,18,1870179934,99.851917,7.010785
IOWA_TAYLOR,1377618880,7133364,9276.56488,14,1384752244,99.484864,6.660428
IOWA_UNION,1097235807,5575853,8010.074951,12,1102811660,99.494397,6.708983
IOWA_VAN BUREN,1255646304,14839918,8112.35675,12,1270486222,98.83195,6.840194
IOWA_WAPELLO,1118453196,10836289,8081.271118,12,1129289485,99.040433,6.79964
IOWA_WARREN,1475873109,9097100,10575.14368,16,1484970209,99.387388,6.650205
IOWA_WASHINGTON,1473215985,5381583,11084.54779,16,1478597568,99.636035,6.953149
IOWA_WAYNE,1361013816,4274254,10711.51965,16,1365288070,99.686934,6.715724
IOWA_WEBSTER,1853677022,7190525,13479.14703,20,1860867547,99.613593,6.765717
IOWA_WINNEBAGO,1037261949,3182052,8079.265503,12,1040444001,99.694164,6.753376
IOWA_WINNESHIEK,1786666637,745729,13900.3075,20,1787412366,99.958279,6.953055
IOWA_WOODBURY,2260790994,12793704,15385.40045,24,2273584698,99.437289,6.446861
IOWA_WORTH,1036314923,4709127,8176.533752,12,1041024050,99.547645,6.844741
IOWA_WRIGHT,1503268903,4703964,10684.44513,16,1507972867,99.68806,6.698674
KANSAS_ALLEN,1295764239,13021929,8704.990112,15,1308786168,99.005038,5.861648
KANSAS_ANDERSON,1501272903,10590765,8629.782715,15,1511863668,99.299489,5.793774
KANSAS_ATCHISON,1116736558,6851102,8088.289429,14,1123587660,99.390248,5.812793
KANSAS_BARBER,2937240786,5411508,14414.72516,29,2942652294,99.816101,4.979753
KANSAS_BARTON,2318705423,13926862,13829.11108,25,2332632285,99.402955,5.564869
KANSAS_BOURBON,1645861886,9377600,12841.38916,22,1655239486,99.43346,5.870252
KANSAS_BROWN,1478550075,3196147,9614.496643,16,1481746222,99.784299,6.02205
KANSAS_BUTLER,3702816817,43671392,23352.35645,41,3746488209,98.834338,5.762872
KANSAS_CHASE,2002199320,12090543,11246.99579,20,2014289863,99.399762,5.657456
KANSAS_CHAUTAUQUA,1654694136,15243776,8930.611816,15,1669937912,99.087165,6.00859
KANSAS_CHEROKEE,1521791028,8951464,9408.929565,16,1530742492,99.415221,5.915172
KANSAS_CHEYENNE,2641501921,2738021,12053.2171,26,2644239942,99.896453,4.640658
KANSAS_CLARK,2524300310,6603384,14635.33325,30,2530903694,99.73909,4.891206
KANSAS_CLAY,1671315283,26701335,10929.11914,20,1698016618,98.427499,5.551863
KANSAS_CLOUD,1852726650,6859888,10812.79877,20,1859586538,99.631107,5.426417
KANSAS_COFFEY,1623623917,70470788,9111.109192,16,1694094705,95.84021,5.941601
KANSAS_COMANCHE,2041681114,3604155,11476.62817,24,2045285269,99.823782,4.79037
KANSAS_COWLEY,2915648165,17322935,17621.56262,30,2932971100,99.409372,5.908753
KANSAS_CRAWFORD,1527498535,13574348,8841.366211,15,1541072883,99.119162,5.946624
KANSAS_DECATUR,2314199329,1631670,12070.26419,25,2315830999,99.929543,4.83151
KANSAS_DICKINSON,2193894223,12632458,12852.41986,24,2206526681,99.427496,5.38601
KANSAS_DONIPHAN,1019105691,12424174,7272.041382,12,1031529865,98.795558,6.133914
KANSAS_DOUGLAS,1180425074,48878066,6373.564575,11,1229303140,96.023921,6.034069
KANSAS_EDWARDS,1610699245,206413,8681.9263,17,1610905658,99.987187,5.10767
KANSAS_ELK,1668636737,16061120,11895.78363,20,1684697857,99.046647,6.005142
KANSAS_ELLIS,2330762299,1197085,12043.18945,23,2331959384,99.948666,5.238859
KANSAS_ELLSWORTH,1853331063,19969761,10994.29895,20,1873300824,98.93398,5.556382
KANSAS_FINNEY,3372157850,1716371,17384.91071,36,3373874221,99.949128,4.8316
KANSAS_FORD,2844508243,2097356,14959.22565,29,2846605599,99.926321,5.162157
KANSAS_FRANKLIN,1480882184,13893466,9256.509766,16,1494775650,99.070532,5.839596
KANSAS_GEARY,996272768,51602808,6464.816406,12,1047875576,95.075483,5.666389
KANSAS_GOVE,2775601943,245369,14468.87436,30,2775847312,99.991161,4.823384
KANSAS_GRAHAM,2327173854,599356,12419.22589,25,2327773210,99.974252,4.96897
KANSAS_GRANT,1488745973,871232,7283.071289,15,1489617205,99.941513,4.846182
KANSAS_GRAY,2250356170,1113338,11316.18604,21,2251469508,99.950551,5.391326
KANSAS_GREELEY,2016057905,0,8549.56131,20,2016057905,100,4.274781
KANSAS_GREENWOOD,2961143639,24145021,16568.66132,29,2985288660,99.1912,5.759918
KANSAS_HAMILTON,2580958328,2893322,12756.15442,29,2583851650,99.888023,4.403605
KANSAS_HARPER,2075290355,3899269,10302.39206,20,2079189624,99.812462,5.160875
KANSAS_HARVEY,1397961184,2503283,8264.776978,15,1400464467,99.821253,5.519718
KANSAS_HASKELL,1495772610,910409,7628.021942,15,1496683019,99.939172,5.088443
KANSAS_HODGEMAN,2227369149,826344,10554.08588,21,2228195493,99.962914,5.02762
KANSAS_JACKSON,1699600349,4666513,10069.75073,18,1704266862,99.726186,5.609666
KANSAS_JEFFERSON,1379350886,62436774,6811.772644,12,1441787660,95.669489,5.933425
KANSAS_JEWELL,2356813567,11367163,13632.56976,25,2368180730,99.520004,5.479328
KANSAS_JOHNSON,1226667300,16331359,6636.288757,11,1242998659,98.686132,6.107691
KANSAS_KEARNY,2254696660,1133601,11591.94589,26,2255830261,99.949748,4.452502
KANSAS_KINGMAN,2236245127,8391920,12801.27881,24,2244637047,99.626135,5.353882
KANSAS_KIOWA,1871627782,596764,10533.02771,21,1872224546,99.968125,5.017327
KANSAS_LABETTE,1671560716,20006201,9301.634277,16,1691566917,98.817298,5.883101
KANSAS_LANE,1858080220,551220,9494.164673,20,1858631440,99.970343,4.748491
KANSAS_LEAVENWORTH,1200213586,14343355,9406.924683,16,1214556941,98.819046,5.943713
KANSAS_LINCOLN,1863226709,2748359,10793.74628,20,1865975068,99.852712,5.404834
KANSAS_LINN,1538662701,31893232,9904.294983,17,1570555933,97.969303,5.946818
KANSAS_LOGAN,2779039721,274632,13506.22141,30,2779314353,99.990119,4.502519
KANSAS_LYON,2194978406,20541643,15745.39172,28,2215520049,99.07283,5.67598
KANSAS_MARION,2445722726,24432825,14801.79163,27,2470155551,99.010879,5.536912
KANSAS_MARSHALL,2331441883,12734901,14156.0127,25,2344176784,99.456743,5.693335
KANSAS_MCPHERSON,2326547432,6003328,13536.3045,25,2332550760,99.742628,5.428493
KANSAS_MEADE,2533222397,3258258,13616.52496,25,2536480655,99.871544,5.453615
KANSAS_MIAMI,1491519074,37235270,9499.178955,16,1528754344,97.564339,6.085202
KANSAS_MITCHELL,1817632931,44979980,10151.97784,19,1862612911,97.585114,5.47537
KANSAS_MONTGOMERY,1666900087,20430012,9388.874634,16,1687330099,98.789211,5.939967
KANSAS_MORRIS,1800929258,19545268,10981.263,20,1820474526,98.926364,5.550221
KANSAS_MORTON,1889993633,507796,9226.426941,20,1890501429,99.97314,4.614453
KANSAS_NEMAHA,1858127940,5205446,11579.91284,20,1863333386,99.720638,5.806177
KANSAS_NEOSHO,1480129683,16350961,7042.408264,12,1496480644,98.907372,5.933505
KANSAS_NESS,2783562233,667491,13549.3403,27,2784229724,99.976026,5.019478
KANSAS_NORTON,2274122713,8421464,12541.56302,25,2282544177,99.631049,5.035203
KANSAS_OSAGE,1827253333,37137002,11360.30841,20,1864390335,98.008089,5.795597
KANSAS_OSBORNE,2311604928,4806274,11100.59186,21,2316411202,99.792512,5.296987
KANSAS_OTTAWA,1866683176,1567629,10637.315,20,1868250805,99.916091,5.323124
KANSAS_PAWNEE,1953531647,992041,10582.16312,20,1954523688,99.949244,5.293768
KANSAS_PHILLIPS,2294395646,22493383,13027.90314,25,2316889029,99.029156,5.262249
KANSAS_POTTAWATOMIE,2177507164,54149295,11845.64526,22,2231656459,97.573583,5.518281
KANSAS_PRATT,1903740948,1771939,11525.76367,22,1905512887,99.90701,5.24386
KANSAS_RAWLINS,2769775708,415527,14594.21991,30,2770191235,99.985,4.86547
KANSAS_RENO,3251231982,43517492,18891.06171,35,3294749474,98.679187,5.469691
KANSAS_REPUBLIC,1857998461,7951912,11105.6059,20,1865950373,99.573841,5.576568
KANSAS_RICE,1880936103,4482698,11015.35718,20,1885418801,99.762244,5.520805
KANSAS_RILEY,1579116617,32002514,8648.835266,16,1611119131,98.013647,5.515071
KANSAS_ROOKS,2306454196,11962259,12848.40842,25,2318416455,99.484033,5.166018
KANSAS_RUSH,1858997555,544720,9632.546387,18,1859542275,99.970707,5.352983
KANSAS_RUSSELL,2295402862,34126776,12950.69067,24,2329529638,98.535036,5.476348
KANSAS_SALINE,1865418116,2773261,10655.36505,20,1868191377,99.851554,5.335603
KANSAS_SCOTT,1858536839,306079,9074.006866,20,1858842918,99.983534,4.537751
KANSAS_SEDGWICK,2582031938,31578728,15481.66577,28,2613610666,98.791759,5.596789
KANSAS_SEWARD,1656693307,1961444,7319.170746,14,1658654751,99.881745,5.234169
KANSAS_SHAWNEE,1409012933,30320698,8423.213562,15,1439333631,97.893421,5.736316
KANSAS_SHERIDAN,2320518304,647342,11875.72794,25,2321165646,99.972111,4.751616
KANSAS_SHERMAN,2735193249,548248,13338.75998,30,2735741497,99.97996,4.447145
KANSAS_SMITH,2319241781,3884267,10814.80438,20,2323126048,99.8328,5.416459
KANSAS_STAFFORD,2051389756,7435417,12411.20374,23,2058825173,99.638851,5.415734
KANSAS_STANTON,1762103387,178555,9336.730896,20,1762281942,99.989868,4.668838
KANSAS_STEVENS,1883593917,464936,9729.814178,20,1884058853,99.975323,4.866108
KANSAS_SUMNER,3060472194,8546399,16416.24109,30,3069018593,99.721527,5.487361
KANSAS_THOMAS,2783425127,288241,14234.22778,30,2783713368,99.989645,4.745234
KANSAS_TREGO,2303727352,26281951,12147.4769,24,2330009303,98.872024,5.119192
KANSAS_WABAUNSEE,2057320865,13845234,10973.24091,20,2071166099,99.331525,5.523544
KANSAS_WALLACE,2366348284,140936,10762.66058,25,2366489220,99.994045,4.305321
KANSAS_WASHINGTON,2317418815,10139123,14164.03394,25,2327557938,99.564388,5.690402
KANSAS_WICHITA,1861078197,61987,8926.600677,21,1861140184,99.996669,4.250904
KANSAS_WILSON,1477385750,12048762,9397.899902,16,1489434512,99.191051,5.92159
KANSAS_WOODSON,1289344336,19254559,9185.313721,16,1308598895,98.528613,5.826552
KANSAS_WYANDOTTE,392739405,11801604,3630.003845,6,404541009,97.082718,6.231806
KENTUCKY_ADAIR,1049691067,18403520,7417.441711,12,1068094587,98.276977,6.289572
KENTUCKY_ALLEN,891838779,19482100,6009.56134,10,911320879,97.862213,6.140839
KENTUCKY_ANDERSON,523607691,5477488,3705.211182,6,529085179,98.964725,6.239953
KENTUCKY_BALLARD,639387454,69473325,4214.614746,7,708860779,90.199299,6.675083
KENTUCKY_BARREN,1262837133,32156068,9123.142273,15,1294993201,97.516893,6.236965
KENTUCKY_BATH,722081430,13486211,5088.022095,8,735567641,98.166557,6.478813
KENTUCKY_BELL,929965649,5321858,5898.254944,9,935287507,99.430992,6.591121
KENTUCKY_BOONE,637873437,26481562,5887.224426,9,664354999,96.013944,6.812928
KENTUCKY_BOURBON,750439352,4829777,4387.090393,7,755269129,99.360522,6.307608
KENTUCKY_BOYD,414054164,5581073,3165.724365,5,419635237,98.670018,6.416791
KENTUCKY_BOYLE,467104121,6450463,2472.814819,4,473554584,98.637863,6.267408
KENTUCKY_BRACKEN,525033515,16140319,3805.48761,6,541173834,97.017535,6.537457
KENTUCKY_BREATHITT,1275352765,7384543,8428.22699,13,1282737308,99.424314,6.520791
KENTUCKY_BRECKINRIDGE,1475790362,40965524,9644.579102,16,1516755886,97.299135,6.195186
KENTUCKY_BULLITT,769306781,8374789,5360.773926,9,777681570,98.923108,6.021258
KENTUCKY_BUTLER,1103571982,13943050,7160.734375,12,1117515032,98.752317,6.042672
KENTUCKY_CALDWELL,893002030,8697603,5490.130127,9,901699633,99.035421,6.159558
KENTUCKY_CALLOWAY,997224264,66474672,6167.998413,10,1063698936,93.750612,6.579155
KENTUCKY_CAMPBELL,391968572,20928149,2627.240356,4,412896721,94.931384,6.918788
KENTUCKY_CARLISLE,490647294,24707972,2986.229614,5,515355266,95.205643,6.27322
KENTUCKY_CARROLL,332995861,22648384,2512.925354,4,355644245,93.63173,6.709599
KENTUCKY_CARTER,1060587154,6788532,7002.297668,11,1067375686,99.363998,6.40647
KENTUCKY_CASEY,1150572403,3891526,7422.455566,12,1154463929,99.662915,6.2063
KENTUCKY_CHRISTIAN,1858341167,16920369,11576.90436,19,1875261536,99.097706,6.148586
KENTUCKY_CLARK,653939112,6912639,5017.828552,8,660851751,98.95398,6.338589
KENTUCKY_CLAY,1215472435,4752710,8431.235474,13,1220225145,99.610505,6.510925
KENTUCKY_CLINTON,510875755,21152699,2536.991699,4,532028454,96.024141,6.605088
KENTUCKY_CRITTENDEN,932300421,28949527,6043.655762,10,961249948,96.988346,6.231322
KENTUCKY_CUMBERLAND,790453070,14793815,5000.781616,8,805246885,98.162822,6.367968
KENTUCKY_DAVIESS,1187227810,47086919,7905.787537,13,1234314729,96.185177,6.32257
KENTUCKY_EDMONSON,784468358,13258105,5405.897949,9,797726463,98.338014,6.108069
KENTUCKY_ELLIOTT,606882499,2601651,3851.614441,6,609484150,99.573139,6.446877
KENTUCKY_ESTILL,655509951,6516335,3165.724365,5,662026286,99.015698,6.394389
KENTUCKY_FAYETTE,734616008,4922115,4989.751404,8,739538123,99.334434,6.27898
KENTUCKY_FLEMING,902727568,7182389,5678.64978,9,909909957,99.210648,6.359812
KENTUCKY_FLOYD,1018596152,6275622,7208.866699,11,1024871774,99.387668,6.593892
KENTUCKY_FRANKLIN,538305689,10792957,3112.578003,5,549098646,98.034423,6.34997
KENTUCKY_FULTON,533359371,64083920,4207.595764,7,597443291,89.27364,6.733064
KENTUCKY_GALLATIN,254700873,16517494,1272.506958,2,271218367,93.909891,6.775149
KENTUCKY_GARRARD,595952848,9957764,4363.024048,7,605910612,98.356562,6.337037
KENTUCKY_GRANT,668157705,7243449,5050.919861,8,675401154,98.927534,6.382096
KENTUCKY_GRAVES,1429041267,13031630,8999.80249,15,1442072897,99.096327,6.054582
KENTUCKY_GRAYSON,1294807622,28747179,9021.863037,15,1323554801,97.828033,6.14811
KENTUCKY_GREEN,740863549,7102448,4867.414063,8,747965997,99.050432,6.142596
KENTUCKY_GREENUP,892153296,25883956,6308.385254,10,918037252,97.180511,6.49141
KENTUCKY_HANCOCK,486071470,29042100,3630.003845,6,515113570,94.362001,6.411486
KENTUCKY_HARDIN,1614589639,17443341,8992.783081,15,1632032980,98.931189,6.059958
KENTUCKY_HARLAN,1206496124,6011471,9270.548645,14,1212507595,99.504212,6.654814
KENTUCKY_HARRISON,793603854,8981533,5014.82019,8,802585387,98.880925,6.339469
KENTUCKY_HART,1068530146,13692527,7224.910522,12,1082222673,98.734777,6.097911
KENTUCKY_HENDERSON,1130509780,76360650,8083.276611,13,1206870430,93.672838,6.637896
KENTUCKY_HENRY,741500310,12501986,4363.024109,7,754002296,98.341917,6.337981
KENTUCKY_HICKMAN,627487969,27882023,4770.146118,8,655369992,95.745606,6.227631
KENTUCKY_HOPKINS,1403944044,31984786,10341.49982,17,1435928830,97.772537,6.221824
KENTUCKY_JACKSON,894051380,3407440,6334.457092,10,897458820,99.620324,6.358599
KENTUCKY_JEFFERSON,986032282,43964666,6584.145325,11,1029996948,95.731573,6.252469
KENTUCKY_JESSAMINE,445905563,6131853,3113.580627,5,452037416,98.643508,6.312794
KENTUCKY_JOHNSON,678485015,5623156,4515.443787,7,684108171,99.178031,6.504096
KENTUCKY_KENTON,415149811,10377911,3282.044861,5,425527722,97.561167,6.728179
KENTUCKY_KNOTT,910427588,3453304,5261.500061,8,913880892,99.622128,6.601822
KENTUCKY_KNOX,1000523173,3743716,7146.695374,11,1004266889,99.627219,6.521306
KENTUCKY_LARUE,677419096,5393445,3598.918213,6,682812541,99.210113,6.045953
KENTUCKY_LAUREL,1124024367,25135701,8291.851501,13,1149160068,97.812689,6.520981
KENTUCKY_LAWRENCE,1076387827,11582519,7693.201599,12,1087970346,98.935401,6.479987
KENTUCKY_LEE,540942126,6215041,3836.573242,6,547157167,98.864121,6.467755
KENTUCKY_LESLIE,1038205991,9189721,7874.70166,12,1047395712,99.122612,6.620337
KENTUCKY_LETCHER,875235599,2856317,5979.478699,9,878091916,99.674713,6.665547
KENTUCKY_LEWIS,1250548600,32481932,8837.354797,14,1283030532,97.468343,6.476355
KENTUCKY_LINCOLN,862060145,9192647,6222.147583,10,871252792,98.944893,6.288498
KENTUCKY_LIVINGSTON,810998697,75642666,6059.69989,10,886641363,91.468629,6.624894
KENTUCKY_LOGAN,1430224005,12479211,9487.145996,16,1442703216,99.135012,5.981203
KENTUCKY_LYON,553848612,110565602,4893.485779,8,664414214,83.358935,7.337974
KENTUCKY_MADISON,1132738966,15297328,7520.726379,12,1148036294,98.667522,6.35191
KENTUCKY_MAGOFFIN,798866769,1847044,7139.676025,11,800713813,99.769325,6.505621
KENTUCKY_MARION,888463711,9891794,6071.733215,10,898355505,98.8989,6.139333
KENTUCKY_MARSHALL,782708021,98329634,6062.708008,10,881037655,88.839338,6.824351
KENTUCKY_MARTIN,594708779,2558129,3881.697388,6,597266908,99.571694,6.497324
KENTUCKY_MASON,621924408,16281528,3763.371399,6,638205936,97.44886,6.43649
KENTUCKY_MCCRACKEN,644190803,50358595,4201.579224,7,694549398,92.749458,6.471473
KENTUCKY_MCCREARY,1105416695,10730402,8353.019836,13,1116147097,99.038621,6.487772
KENTUCKY_MCLEAN,654041005,9606626,3650.059082,6,663647631,98.552451,6.172786
KENTUCKY_MEADE,791093698,49364379,5428.961487,9,840458077,94.126491,6.408588
KENTUCKY_MENIFEE,527283203,6084693,3842.589966,6,533367896,98.859194,6.478221
KENTUCKY_MERCER,645065865,10998444,4316.896912,7,656064309,98.323572,6.272144
KENTUCKY_METCALFE,750166102,4012303,4316.897034,7,754178405,99.46799,6.19998
KENTUCKY_MONROE,853220885,6801900,7446.521912,12,860022785,99.209102,6.254905
KENTUCKY_MONTGOMERY,511132776,3856041,3158.705017,5,514988817,99.251238,6.365069
KENTUCKY_MORGAN,987114229,6889951,6435.735718,10,994004180,99.306849,6.480656
KENTUCKY_MUHLENBERG,1210451475,31188648,7255.996521,12,1241640123,97.488109,6.202463
KENTUCKY_NELSON,1081366442,16985926,7213.88031,12,1098352368,98.453509,6.105996
KENTUCKY_NICHOLAS,505465731,4302198,3766.379761,6,509767929,99.156048,6.330728
KENTUCKY_OHIO,1521059918,23162111,10819.81775,18,1544222029,98.500079,6.102543
KENTUCKY_OLDHAM,484953303,23806527,3047.398254,5,508759830,95.320675,6.393992
KENTUCKY_OWEN,909365295,8129123,5012.814697,8,917494418,99.113987,6.322032
KENTUCKY_OWSLEY,511288846,2279908,3210.848633,5,513568754,99.556066,6.450333
KENTUCKY_PENDLETON,717836518,12328140,4439.234009,7,730164658,98.311595,6.450676
KENTUCKY_PERRY,879818914,7535303,5901.263184,9,887354217,99.150812,6.613117
KENTUCKY_PIKE,2037621870,4756759,13769.94818,21,2042378629,99.767097,6.572426
KENTUCKY_POWELL,463558849,2953274,3169.735535,5,466512123,99.366946,6.379859
KENTUCKY_PULASKI,1705275134,48546023,12000.07117,19,1753821157,97.231986,6.495627
KENTUCKY_ROBERTSON,258794974,484952,2505.905945,4,259279926,99.812962,6.276504
KENTUCKY_ROCKCASTLE,819853864,4011241,4397.117981,7,823865105,99.513119,6.312331
KENTUCKY_ROWAN,724781543,16641413,5754.85968,9,741422956,97.755476,6.541105
KENTUCKY_RUSSELL,657060481,75583987,4383.079346,7,732644468,89.683402,6.981829
KENTUCKY_SCOTT,729774435,9440820,6256.241516,10,739215255,98.722859,6.337176
KENTUCKY_SHELBY,983610918,15252803,8003.055542,13,998863721,98.472985,6.25166
KENTUCKY_SIMPSON,606589172,5852914,3543.766479,6,612442086,99.044332,5.963267
KENTUCKY_SPENCER,483611359,12788680,3032.35675,5,496400039,97.423715,6.22509
KENTUCKY_TAYLOR,689891728,27072003,4863.402771,8,716963731,96.224076,6.317809
KENTUCKY_TODD,969958282,6612452,6002.542847,10,976570734,99.322891,6.043464
KENTUCKY_TRIGG,1143637621,102999105,8000.04718,13,1246636726,91.737841,6.708118
KENTUCKY_TRIMBLE,392766455,11833375,3092.522766,5,404599830,97.075289,6.37139
KENTUCKY_UNION,887992798,53149363,6107.832336,10,941142161,94.352674,6.473407
KENTUCKY_WARREN,1403048148,15136940,7734.314453,13,1418185088,98.932654,6.013659
KENTUCKY_WASHINGTON,769154199,10947539,4264.752869,7,780101738,98.596652,6.17922
KENTUCKY_WAYNE,1186690748,67283816,8274.804688,13,1253974564,94.634356,6.726135
KENTUCKY_WEBSTER,860132094,9211730,4236.675659,7,869343824,98.940381,6.117213
KENTUCKY_WHITLEY,1133976640,18875287,7738.325684,12,1152851927,98.362731,6.555943
KENTUCKY_WOLFE,575419135,1505160,3861.64209,6,576924295,99.739106,6.452905
KENTUCKY_WOODFORD,492386256,4933229,3106.561279,5,497319485,99.008036,6.275372
LOUISIANA_ACADIA,1696880727,5918557,10399.65997,17,1702799284,99.652422,6.138784
LOUISIANA_ALLEN,1973083805,10634063,13761.92627,22,1983717868,99.463933,6.289135
LOUISIANA_ASCENSION,751259388,32965758,4878.444519,8,784225146,95.796391,6.365642
LOUISIANA_ASSUMPTION,877029981,67099711,5628.511719,9,944129692,92.892956,6.732375
LOUISIANA_AVOYELLES,2154960193,87260913,12582.67627,21,2242221106,96.108282,6.234375
LOUISIANA_BEAUREGARD,2997555223,21945878,20648.90613,33,3019501101,99.273195,6.303055
LOUISIANA_BIENVILLE,2101207369,27945994,14308.4325,23,2129153363,98.68746,6.303797
LOUISIANA_BOSSIER,2176404826,70298996,14243.25275,23,2246703822,96.871016,6.392747
LOUISIANA_CADDO,2276773700,148972461,16902.58167,27,2425746161,93.858695,6.66983
LOUISIANA_CALCASIEU,2756144275,78003935,17060.01544,28,2834148210,97.247712,6.265302
LOUISIANA_CALDWELL,1371371987,29109145,9348.76416,15,1400481132,97.92149,6.364803
LOUISIANA_CAMERON,3327796101,1688162100,12118.39648,20,5015958201,66.344175,9.132977
LOUISIANA_CATAHOULA,1833782907,81308666,12193.60376,20,1915091573,95.75432,6.36713
LOUISIANA_CLAIBORNE,1955125376,32473223,12940.6629,21,1987598599,98.366208,6.26457
LOUISIANA_CONCORDIA,1805172274,130329992,12529.52979,21,1935502266,93.266348,6.397209
LOUISIANA_DE SOTO,2269932580,46995296,14511.99347,23,2316927876,97.971655,6.440192
LOUISIANA_EAST BATON ROUGE,1179460545,38442235,7763.394775,13,1217902780,96.843571,6.166483
LOUISIANA_EAST CARROLL,1089628528,56264652,6062.70813,10,1145893180,95.089887,6.375765
LOUISIANA_EAST FELICIANA,1174307281,6151756,7890.745972,13,1180459037,99.478867,6.101602
LOUISIANA_EVANGELINE,1715558149,44659723,10533.02783,17,1760217872,97.46283,6.357191
LOUISIANA_FRANKLIN,1617688504,28087065,11007.33502,18,1645775569,98.293384,6.221361
LOUISIANA_GRANT,1665429793,56013945,10809.79065,17,1721443738,96.746107,6.572565
LOUISIANA_IBERIA,1486894804,1182161751,8536.525696,14,2669056555,55.708629,10.945375
LOUISIANA_IBERVILLE,1602243589,88655994,10140.94733,17,1690899583,94.756874,6.295335
LOUISIANA_JACKSON,1474183476,28727342,11318.19165,18,1502910818,98.088553,6.410416
LOUISIANA_JEFFERSON,765849559,897018001,3620.979126,6,1662867560,46.055956,13.10355
LOUISIANA_JEFFERSON DAVIS,1687025359,18718207,12249.75885,20,1705743566,98.902637,6.192837
LOUISIANA_LA SALLE,1617925445,97664170,11791.49616,19,1715589615,94.307253,6.580672
LOUISIANA_LAFAYETTE,696088606,1149882,3631.006775,6,697238488,99.835081,6.061675
LOUISIANA_LAFOURCHE,2767038601,1037509108,12697.99426,20,3804547709,72.729765,8.729572
LOUISIANA_LINCOLN,1221806127,1897706,8722.037109,14,1223703833,99.844921,6.239703
LOUISIANA_LIVINGSTON,1678761759,112107033,10378.60254,17,1790868792,93.740076,6.512754
LOUISIANA_MADISON,1617200406,68596533,10973.24097,18,1685796939,95.930914,6.354828
LOUISIANA_MOREHOUSE,2058860093,28888919,13866.21387,23,2087749012,98.616265,6.113382
LOUISIANA_NATCHITOCHES,3243376637,120998331,22113.94367,35,3364374968,96.403542,6.553981
LOUISIANA_ORLEANS,438830826,467267624,1802.968628,3,906098450,48.430811,12.40924
LOUISIANA_OUACHITA,1580933156,55293049,10502.94507,17,1636226205,96.620697,6.394285
LOUISIANA_PLAQUEMINES,2020951599,4628120213,1791.938354,3,6649071812,30.394492,19.652008
LOUISIANA_POINTE COUPEE,1443191040,86747117,10580.1579,18,1529938157,94.330025,6.231171
LOUISIANA_RAPIDES,3419675969,106999766,25206.46637,40,3526675735,96.965988,6.498791
LOUISIANA_RED RIVER,1007742987,34323733,6850.88031,11,1042066720,96.706187,6.440201
LOUISIANA_RICHLAND,1439329200,22784622,9712.767517,16,1462113822,98.441666,6.166576
LOUISIANA_SABINE,2244636625,375317817,17097.11792,27,2619954442,85.674643,7.391062
LOUISIANA_SAINT BERNARD,977751170,4604202847,288.777088,0.482968,5581954017,17.516289,34.135162
LOUISIANA_SAINT CHARLES,719371428,308636642,4359.013,7,1028008070,69.977216,8.898841
LOUISIANA_SAINT HELENA,1057772649,2796210,6823.805725,11,1060568859,99.736348,6.219859
LOUISIANA_SAINT JAMES,628956073,38794711,4359.012878,7,667750784,94.190241,6.611259
LOUISIANA_SAINT JOHN THE BAPTIST,555086131,506438994,3109.569641,5,1061525125,52.291379,11.89324
LOUISIANA_SAINT LANDRY,2392922808,39029116,14430.76935,24,2431951924,98.395153,6.110891
LOUISIANA_SAINT MARTIN,1909395777,205311872,13897.29919,23,2114707649,90.291241,6.692016
LOUISIANA_SAINT MARY,1438956831,1460334138,11361.31061,18,2899290969,49.631336,12.717448
LOUISIANA_SAINT TAMMANY,2189053583,648481703,12311.93024,20,2837535286,77.146303,7.979598
LOUISIANA_TANGIPAHOA,2049482871,136678798,13709.7829,22,2186161669,93.748001,6.647309
LOUISIANA_TENSAS,1561204507,99471077,11560.86017,19,1660675584,94.010204,6.472343
LOUISIANA_TERREBONNE,3185239627,2207173188,11610.99817,18,5392412815,59.068913,10.920388
LOUISIANA_UNION,2271261418,73624033,12975.75964,21,2344885451,96.860229,6.379226
LOUISIANA_VERMILION,3038604870,955337105,15808.56647,26,3993941975,76.080346,7.991838
LOUISIANA_VERNON,3439290592,35139148,20858.48395,33,3474429740,98.988636,6.385332
LOUISIANA_WASHINGTON,1734245451,16281952,12726.07153,20,1750527403,99.069883,6.422775
LOUISIANA_WEBSTER,1536337099,56090611,9848.140381,16,1592427710,96.477667,6.379806
LOUISIANA_WEST BATON ROUGE,498293566,29602577,4115.341553,7,527896143,94.392348,6.228322
LOUISIANA_WEST CARROLL,931478638,2386184,6596.178223,11,933864822,99.744483,6.011887
LOUISIANA_WEST FELICIANA,1044589938,58751920,6506.932495,11,1103341858,94.675094,6.248099
LOUISIANA_WINN,2460711980,17448075,17135.22315,27,2478160055,99.295926,6.391379
MAINE_ANDROSCOGGIN,1211990512,75546586,7991.022644,13,1287537098,94.132473,6.530096
MAINE_AROOSTOOK,17278050008,404838270,111821.1655,186,17682888278,97.710565,6.152754
MAINE_CUMBERLAND,2165087512,988124422,13072.0249,21,3153211934,68.662924,9.065699
MAINE_FRANKLIN,4395220899,121290428,28472.46655,48,4516511327,97.314511,6.095457
MAINE_HANCOCK,4110637088,1962704711,22469.92578,38,6073341799,67.683283,8.736483
MAINE_KENNEBEC,2246734973,216795650,15518.76813,25,2463530623,91.199799,6.806492
MAINE_KNOX,945697332,2017103596,3747.327271,6,2962800928,31.919031,19.566839
MAINE_LINCOLN,1180688991,631299424,7533.76239,12,1811988415,65.159853,9.634975
MAINE_OXFORD,5379284550,255893091,35193.99066,59,5635177641,95.459006,6.248843
MAINE_PENOBSCOT,8798699751,413983068,55344.52167,94,9212682819,95.506379,6.164735
MAINE_PISCATAQUIS,10259018205,1080044969,65900.61414,111,11339063174,90.475007,6.562025
MAINE_SAGADAHOC,657782149,300590925,1869.151184,3,958373074,68.635291,9.077697
MAINE_SOMERSET,10163845447,437943208,66428.06873,110,10601788655,95.869157,6.299122
MAINE_WALDO,1890615339,318015805,12923.61609,21,2208631144,85.601226,7.18927
MAINE_WASHINGTON,6637431507,1799884965,42362.74731,70,8437316472,78.667566,7.692905
MAINE_YORK,2566874777,721658621,16525.5426,26,3288533398,78.055305,8.142916
MARYLAND_ALLEGANY,1093462025,14801442,7333.20929,11,1108263467,98.664447,6.756794
MARYLAND_ANNE ARUNDEL,1074353655,448033072,6171.00647,10,1522386727,70.570351,8.744475
MARYLAND_BALTIMORE,1549745106,215959023,10238.21539,16,1765704129,87.769241,7.290578
MARYLAND_CALVERT,552162128,341577085,2414.65448,4,893739213,61.781124,9.771004
MARYLAND_CAROLINE,827350252,16777066,5160.220764,8,844127318,98.012496,6.581075
MARYLAND_CARROLL,1159352918,13112465,9589.427368,15,1172465383,98.881633,6.465257
MARYLAND_CECIL,896909987,185283751,5137.157166,8,1082193738,82.878874,7.747989
MARYLAND_CHARLES,1185688597,479508078,8303.883911,14,1665196675,71.204117,8.33006
MARYLAND_DORCHESTER,1400573745,1145353068,7706.237488,12,2545926813,55.012333,11.6735
MARYLAND_FREDERICK,1710755614,17840723,12003.07947,19,1728596337,98.967907,6.383292
MARYLAND_GARRETT,1681102437,22498420,12110.37482,18,1703600857,98.679361,6.818028
MARYLAND_HARFORD,1132148068,231889650,7716.264893,12,1364037718,82.999763,7.747276
MARYLAND_HOWARD,649952136,6336142,3753.34375,6,656288278,99.034549,6.316556
MARYLAND_KENT,717516438,353302295,3832.562134,6,1070818733,67.00634,9.532835
MARYLAND_MONTGOMERY,1277027149,35852731,7938.878357,13,1312879880,97.269154,6.27828
MARYLAND_PRINCE GEORGE'S,1250062233,41917744,7850.635376,13,1291979977,96.755542,6.241452
MARYLAND_QUEEN ANNE'S,962673216,360020725,5745.834961,9,1322693941,72.781252,8.771848
MARYLAND_SAINT MARYS,929021301,1050381198,4809.253723,8,1979402499,46.934431,12.808437
MARYLAND_SOMERSET,828145299,752652868,3893.730652,6,1580798167,52.387795,12.387525
MARYLAND_TALBOT,695561625,539363462,3172.743774,5,1234925087,56.324196,11.266006
MARYLAND_WASHINGTON,1185611700,24801555,8359.036621,13,1210413255,97.950985,6.564537
MARYLAND_WICOMICO,969744608,66787195,6583.14209,10,1036531803,93.556667,7.036529
MARYLAND_WORCESTER,1213155089,586532498,7237.946777,11,1799687587,67.409205,9.761206
MASSACHUSETTS_BARNSTABLE,1021019039,2360316945,2529.972351,4,3381335984,30.195729,20.946442
MASSACHUSETTS_BERKSHIRE,2400600620,50708156,17362.84967,27,2451308776,97.931384,6.566521
MASSACHUSETTS_BRISTOL,1432544616,357465834,9542.297607,15,1790010450,80.029958,7.948938
MASSACHUSETTS_DUKES,267300554,1004283854,630.73822,1,1271584408,21.021063,30.005059
MASSACHUSETTS_ESSEX,1275609141,870172223,7772.419739,12,2145781364,59.447303,10.895392
MASSACHUSETTS_FRANKLIN,1810916209,65604206,13220.4342,21,1876520415,96.503944,6.52351
MASSACHUSETTS_HAMPDEN,1598023769,44390005,10820.82086,17,1642413774,97.29727,6.542001
MASSACHUSETTS_HAMPSHIRE,1365534282,46667009,9524.247742,15,1412201291,96.695442,6.566492
MASSACHUSETTS_MIDDLESEX,2118225748,75328648,14778.72833,23,2193554396,96.565909,6.65404
MASSACHUSETTS_NANTUCKET,119566672,666897066,0,0,786463738,15.203075,0
MASSACHUSETTS_NORFOLK,1025912910,124953176,7737.322754,12,1150866086,89.142683,7.233088
MASSACHUSETTS_PLYMOUTH,1705716224,1125905214,11505.70837,18,2831621438,60.238145,10.609793
MASSACHUSETTS_SUFFOLK,150863059,160514693,712.310976,1.09925,311377752,48.450173,13.372328
MASSACHUSETTS_WORCESTER,3912554985,177455990,27929.97186,44,4090010975,95.661234,6.635625
MICHIGAN_ALCONA,1747349266,2890404970,10968.2273,19,4637754236,37.676625,15.321837
MICHIGAN_ALGER,2369925449,10703519680,13214.41773,22,13073445129,18.127781,33.134522
MICHIGAN_ALLEGAN,2137395807,2610802947,15007.3584,23,4748198754,45.014877,14.495071
MICHIGAN_ALPENA,1481127630,2908710755,7480.615845,13,4389838385,33.739913,17.054934
MICHIGAN_ANTRIM,1232002671,326536776,8179.541565,14,1558539447,79.04854,7.391066
MICHIGAN_ARENAC,940627657,822313309,5323.671509,9,1762940966,53.355596,11.086355
MICHIGAN_BARAGA,2326914366,441619428,14156.01209,24,2768533794,84.048617,7.01777
MICHIGAN_BARRY,1432508482,62024197,10374.59094,16,1494532679,95.849927,6.764866
MICHIGAN_BAY,1145399057,488149217,6667.374329,11,1633548274,70.117246,8.644449
MICHIGAN_BENZIE,828014431,1398245684,5982.487183,10,2226260115,37.193068,16.084952
MICHIGAN_BERRIEN,1470543783,2625449730,10921.09717,17,4095993513,35.902005,17.893638
MICHIGAN_BRANCH,1311605515,34420092,7776.430847,12,1346025607,97.442835,6.650421
MICHIGAN_CALHOUN,1829206358,31260656,13013.86456,20,1860467014,98.319741,6.618134
MICHIGAN_CASS,1269366892,47148115,7750.358948,12,1316515007,96.418718,6.698526
MICHIGAN_CHARLEVOIX,1078288786,2522931119,5228.408936,9,3601219905,29.94232,19.401781
MICHIGAN_CHEBOYGAN,1852551949,440619492,12853.42194,22,2293171441,80.785584,7.232063
MICHIGAN_CHIPPEWA,4036515589,2952489038,19786.52972,33,6989004627,57.755228,10.381602
MICHIGAN_CLARE,1461700232,28500461,9001.807922,15,1490200693,98.087475,6.118218
MICHIGAN_CLINTON,1467017475,21098128,9993.541077,16,1488115603,98.582225,6.33579
MICHIGAN_CRAWFORD,1441077804,17917861,8916.573242,15,1458995665,98.771904,6.018293
MICHIGAN_DELTA,3033137838,2124389421,16919.62866,28,5157527259,58.809924,10.272866
MICHIGAN_DICKINSON,1970845139,40505952,12577.66284,21,2011351091,97.986132,6.11246
MICHIGAN_EATON,1489767393,10957924,9614.496582,15,1500725317,99.269825,6.45681
MICHIGAN_EMMET,1210872498,1073487484,5820.039307,10,2284359982,53.007079,10.97974
MICHIGAN_GENESEE,1649653741,32768944,11091.56744,18,1682422685,98.052276,6.284384
MICHIGAN_GLADWIN,1299620448,36677052,8454.299072,14,1336297500,97.255323,6.209208
MICHIGAN_GOGEBIC,2854517941,970153215,19962.01233,33,3824671156,74.634337,8.103694
MICHIGAN_GRAND TRAVERSE,1202625065,354771227,6573.114746,11,1557396292,77.220234,7.738333
MICHIGAN_GRATIOT,1472098934,8369164,9304.642517,15,1480468098,99.434695,6.238361
MICHIGAN_HILLSDALE,1549207129,22939158,11606.98712,18,1572146287,98.540902,6.543807
MICHIGAN_HOUGHTON,2613558378,1275354760,14109.88477,24,3888913138,67.205368,8.74799
MICHIGAN_HURON,2165285423,3369008769,11893.77783,20,5534294192,39.12487,15.199766
MICHIGAN_INGHAM,1440196596,12045815,9442.021301,15,1452242411,99.170537,6.34733
MICHIGAN_IONIA,1479710906,22590318,10113.87286,16,1502301224,98.496286,6.417674
MICHIGAN_IOSCO,1422173770,3473068812,8080.268127,14,4895242582,29.052161,19.866405
MICHIGAN_IRON,3019919277,116800609,20413.25659,34,3136719886,96.276346,6.23611
MICHIGAN_ISABELLA,1483282623,12948097,9773.935974,16,1496230720,99.134619,6.162035
MICHIGAN_JACKSON,1817863745,55974539,12801.27881,20,1873838284,97.01284,6.597724
MICHIGAN_KALAMAZOO,1455523647,47441742,10444.78449,16,1502965389,96.843457,6.740765
MICHIGAN_KALKASKA,1449729125,28020185,8833.344055,15,1477749310,98.103861,6.002716
MICHIGAN_KENT,2198576456,59743330,15144.73712,24,2258319786,97.354523,6.481781
MICHIGAN_KEWEENAW,1398883258,14053673396,5174.259155,9,15452556654,9.052763,63.50743
MICHIGAN_LAKE,1470054606,17489708,9827.082336,16,1487544314,98.824256,6.214999
MICHIGAN_LAPEER,1675675444,41083140,11077.5285,18,1716758584,97.606936,6.305067
MICHIGAN_LEELANAU,899241895,5659105307,5966.442871,10,6558347202,13.71141,43.514436
MICHIGAN_LENAWEE,1941504139,30519590,12557.6073,20,1972023729,98.452372,6.377504
MICHIGAN_LIVINGSTON,1463996483,52197854,9895.27002,16,1516194337,96.557311,6.40505
MICHIGAN_LUCE,2328593560,2624711552,15473.64356,26,4953305112,47.010905,12.659619
MICHIGAN_MACKINAC,2646617358,2793791914,13688.724,23,5440409272,48.647394,12.234199
MICHIGAN_MACOMB,1241050552,237627819,7803.505798,13,1478678371,83.929716,7.152052
MICHIGAN_MANISTEE,1404616391,1912438851,8401.152893,14,3317055242,42.345282,14.171174
MICHIGAN_MARQUETTE,4685406068,4185352679,29743.9715,50,8870758747,52.818549,11.262699
MICHIGAN_MASON,1281969422,1935610414,7918.823242,13,3217579836,39.842661,15.288644
MICHIGAN_MECOSTA,1437772998,41736347,9735.830627,16,1479509345,97.179041,6.261529
MICHIGAN_MENOMINEE,2704053268,761798738,18624.32623,31,3465852006,78.019871,7.700406
MICHIGAN_MIDLAND,1337157039,30534681,9206.371643,15,1367691720,97.76743,6.277736
MICHIGAN_MISSAUKEE,1462793646,23588781,9496.170776,16,1486382427,98.413007,6.030815
MICHIGAN_MONROE,1422810326,338211262,8695.96521,14,1761021588,80.794599,7.687895
MICHIGAN_MONTCALM,1826793467,39944680,12361.06574,20,1866738147,97.860188,6.315676
MICHIGAN_MONTMORENCY,1415881032,41352700,9402.913452,16,1457233732,97.162247,6.048461
MICHIGAN_MUSKEGON,1305130138,2476314278,9605.471619,15,3781444416,34.514064,18.553734
MICHIGAN_NEWAYGO,2172706351,59083038,14987.30341,24,2231789389,97.352661,6.414524
MICHIGAN_OAKLAND,2245928625,103804387,16173.57263,26,2349733012,95.58229,6.508114
MICHIGAN_OCEANA,1393667732,1988728270,8191.575256,13,3382396002,41.203565,15.29288
MICHIGAN_OGEMAW,1459466634,29641291,9497.172913,16,1489107925,98.00946,6.056286
MICHIGAN_ONTONAGON,3395416179,6292279424,20407.2406,34,9687695603,35.04875,17.12384
MICHIGAN_OSCEOLA,1466674350,17425112,9033.896362,15,1484099462,98.82588,6.09415
MICHIGAN_OSCODA,1465088063,15136485,8921.58667,15,1480224548,98.97742,6.009173
MICHIGAN_OTSEGO,1333860412,29050564,8230.683289,14,1362910976,97.868491,6.007101
MICHIGAN_OTTAWA,1459487790,2765845605,9667.642639,15,4225333395,34.541364,18.654363
MICHIGAN_PRESQUE ISLE,1706069658,4957327101,9780.956299,17,6663396759,25.603603,22.48802
MICHIGAN_ROSCOMMON,1346526274,155723123,9544.302734,16,1502249397,89.634003,6.655052
MICHIGAN_SAGINAW,2073813743,39527607,14106.87677,23,2113341350,98.129616,6.25033
MICHIGAN_SAINT CLAIR,1868251511,298290824,11067.50092,19,2166542335,86.231941,6.755038
MICHIGAN_SAINT JOSEPH,1296536370,52915575,10343.50519,16,1349451945,96.078736,6.728534
MICHIGAN_SANILAC,2493046958,1624881028,15951.96234,27,4117927986,60.541296,9.765338
MICHIGAN_SCHOOLCRAFT,3035145674,1844210517,19862.73908,33,4879356191,62.203815,9.676274
MICHIGAN_SHIAWASSEE,1375178357,25853173,9243.474243,15,1401031530,98.154704,6.278167
MICHIGAN_TUSCOLA,2084165734,282852168,12233.71472,20,2367017902,88.050273,6.947006
MICHIGAN_VAN BUREN,1574265761,1248571787,11132.68042,17,2822837548,55.768911,11.742448
MICHIGAN_WASHTENAW,1828437283,42625748,12459.33649,20,1871063031,97.721843,6.374898
MICHIGAN_WAYNE,1584501319,157900250,9340.742188,15,1742401569,90.937781,6.847717
MICHIGAN_WEXFORD,1463148726,27182043,9664.634521,16,1490330769,98.176107,6.152614
MINNESOTA_AITKIN,4718433588,449373340,32750.25549,51,5167806928,91.304371,7.0332
MINNESOTA_ANOKA,1092880512,62442714,9872.206543,15,1155323226,94.595217,6.957509
MINNESOTA_BECKER,3406052328,336954677,24751.21179,40,3743007005,90.997755,6.799951
MINNESOTA_BELTRAMI,6487154450,1426287781,45932.58478,71,7913442231,81.976392,7.891959
MINNESOTA_BENTON,1057483359,12286988,6410.667053,10,1069770347,98.851437,6.485153
MINNESOTA_BIG STONE,1292861685,74956395,7368.306152,12,1367818080,94.520003,6.496249
MINNESOTA_BLUE EARTH,1936751358,46116965,13391.90643,20,1982868323,97.67423,6.855394
MINNESOTA_BROWN,1582765932,18533955,11226.93982,17,1601299887,98.842568,6.681415
MINNESOTA_CARLTON,2230766984,36187853,16025.16333,25,2266954837,98.40368,6.51405
MINNESOTA_CARVER,917364672,56752409,7305.132019,11,974117081,94.173964,7.051874
MINNESOTA_CASS,5235592104,1016598355,37092.22205,58,6252190459,83.740125,7.636973
MINNESOTA_CHIPPEWA,1505260387,17239140,7662.115906,12,1522499527,98.867708,6.458223
MINNESOTA_CHISAGO,1074585062,71183407,8592.680359,13,1145768469,93.787278,7.047602
MINNESOTA_CLAY,2707051032,19306173,18490.95905,30,2726357205,99.291869,6.207611
MINNESOTA_CLEARWATER,2586947430,80206137,18257.31513,28,2667153567,96.992819,6.723876
MINNESOTA_COOK,3762134457,4887728303,24162.58899,40,8649862760,43.493574,13.888597
MINNESOTA_COTTONWOOD,1657522315,22249932,11978.01001,18,1679772247,98.67542,6.743777
MINNESOTA_CROW WING,2585751598,409699376,18406.72711,29,2995450974,86.322615,7.352821
MINNESOTA_DAKOTA,1456983368,62843887,10196.0993,15,1519827255,95.865064,7.090591
MINNESOTA_DODGE,1137724834,800245,8238.704773,12,1138525079,99.929712,6.870416
MINNESOTA_DOUGLAS,1649184455,215620028,12266.80597,20,1864804483,88.437392,6.935305
MINNESOTA_FARIBAULT,1845309105,24414852,13449.06421,20,1869723957,98.6942,6.813503
MINNESOTA_FILLMORE,2230746821,2055506,15112.6485,22,2232802327,99.907941,6.875715
MINNESOTA_FREEBORN,1831756453,39305226,13634.57556,20,1871061679,97.899309,6.963571
MINNESOTA_GOODHUE,1959861773,59175418,13690.7301,20,2019037191,97.069127,7.052052
MINNESOTA_GRANT,1418785986,71704973,9723.797791,16,1490490959,95.189171,6.384522
MINNESOTA_HENNEPIN,1434450857,136547192,11285.1004,17,1570998049,91.308252,7.270202
MINNESOTA_HOUSTON,1429786020,43494665,10980.26038,16,1473280685,97.047768,7.071428
MINNESOTA_HUBBARD,2398345712,190324761,17979.54962,28,2588670473,92.64778,6.930838
MINNESOTA_ISANTI,1128561671,41172752,6466.821655,10,1169734423,96.480162,6.702747
MINNESOTA_ITASCA,6908331692,674867931,49106.33032,76,7583199623,91.100486,7.092563
MINNESOTA_JACKSON,1820689416,42120425,13406.948,20,1862809841,97.738877,6.858554
MINNESOTA_KANABEC,1351000097,31233444,9652.60144,15,1382233541,97.740364,6.583838
MINNESOTA_KANDIYOHI,2065210393,168281911,15333.25671,24,2233492304,92.465525,6.909448
MINNESOTA_KITTSON,2845915560,12391036,17208.42462,27,2858306596,99.56649,6.401241
MINNESOTA_KOOCHICHING,8041217741,127603355,57615.78168,89,8168821096,98.437922,6.576233
MINNESOTA_LAC QUI PARLE,1981394517,33643134,13489.17432,21,2015037651,98.330397,6.532483
MINNESOTA_LAKE,5462973366,2282694247,38869.11945,62,7745667613,70.529406,8.887906
MINNESOTA_LAKE OF THE WOODS,3361369356,1247693914,21100.1496,33,4609063270,72.929556,8.767344
MINNESOTA_LE SUEUR,1162049825,65135543,7419.447144,11,1227185368,94.692282,7.123022
MINNESOTA_LINCOLN,1390257746,30175154,9897.275818,15,1420432900,97.875637,6.741396
MINNESOTA_LYON,1850315129,18794794,12628.80347,19,1869109923,98.994452,6.714254
MINNESOTA_MAHNOMEN,1444868073,64851531,10387.62708,16,1509719604,95.704399,6.783666
MINNESOTA_MARSHALL,4597384471,98019716,28332.07947,44,4695404187,97.912433,6.576396
MINNESOTA_MARTIN,1844928064,44669375,13371.8512,20,1889597439,97.636037,6.847805
MINNESOTA_MCLEOD,1272943172,36367409,9167.263855,14,1309310581,97.2224,6.73512
MINNESOTA_MEEKER,1574893021,95067984,11697.23602,18,1669961005,94.307173,6.890742
MINNESOTA_MILLE LACS,1482415009,282932659,10222.17163,16,1765347668,83.972978,7.60823
MINNESOTA_MORRISON,2913980722,73275535,22430.8169,35,2987256257,97.547062,6.569962
MINNESOTA_MOWER,1842332264,617235,13032.91693,19,1842949499,99.966508,6.861728
MINNESOTA_MURRAY,1825073511,38432254,13281.60217,20,1863505765,97.937637,6.780643
MINNESOTA_NICOLLET,1161894042,47483749,7285.07666,11,1209377791,96.073704,6.893454
MINNESOTA_NOBLES,1852081296,19315969,13289.62439,20,1871397265,98.967832,6.714113
MINNESOTA_NORMAN,2260512789,10208058,15250.02728,24,2270720847,99.550449,6.382872
MINNESOTA_OLMSTED,1692860704,3226228,10970.23261,16,1696086932,99.809784,6.869462
MINNESOTA_OTTER TAIL,5107086047,654451230,36471.5108,61,5761537277,88.641031,6.745111
MINNESOTA_PENNINGTON,1596928772,4332047,12837.37842,20,1601260819,99.72946,6.439405
MINNESOTA_PINE,3655220986,60262764,25214.48779,39,3715483750,98.378064,6.571844
MINNESOTA_PIPESTONE,1204489353,2347615,7939.881226,12,1206836968,99.805474,6.629464
MINNESOTA_POLK,5105054562,69201099,37661.79169,59,5174255661,98.662588,6.469883
MINNESOTA_POPE,1734075761,123230761,12432.26184,20,1857306522,93.365082,6.657875
MINNESOTA_RAMSEY,394308034,46262112,2688.408936,4,440570146,89.49949,7.509565
MINNESOTA_RED LAKE,1119929324,227815,6409.664307,10,1120157139,99.979662,6.410968
MINNESOTA_REDWOOD,2275493336,8220826,17788.02161,27,2283714162,99.640024,6.611958
MINNESOTA_RENVILLE,2545744685,10851893,14953.20898,23,2556596578,99.575534,6.529109
MINNESOTA_RICE,1284215162,52066242,9557.338928,14,1336281404,96.103647,7.103446
MINNESOTA_ROCK,1249560753,698231,7919.825928,12,1250258984,99.944153,6.603543
MINNESOTA_ROSEAU,4329471929,16913419,28342.10657,44,4346385348,99.610862,6.466552
MINNESOTA_SAINT LOUIS,16180477493,1585574379,115411.0621,182,17766051872,91.075258,6.962667
MINNESOTA_SCOTT,922692855,31375656,5401.886963,8,954068511,96.711383,6.981969
MINNESOTA_SHERBURNE,1121230382,46966083,7057.449646,11,1168196465,95.979608,6.684611
MINNESOTA_SIBLEY,1525073949,30338004,11202.87378,17,1555411953,98.04952,6.721018
MINNESOTA_STEARNS,3477827398,122169699,24487.4848,38,3599997097,96.606395,6.670443
MINNESOTA_STEELE,1112775688,6976791,7542.787109,11,1119752479,99.376935,6.900071
MINNESOTA_STEVENS,1459744432,30322722,9807.026978,16,1490067154,97.96501,6.256715
MINNESOTA_SWIFT,1921727343,26202759,13087.06665,21,1947930102,98.654841,6.316909
MINNESOTA_TODD,2447760759,89134294,17630.58801,28,2536895053,96.486481,6.525928
MINNESOTA_TRAVERSE,1486320975,31025234,9732.822449,16,1517346209,97.955296,6.20999
MINNESOTA_WABASHA,1354435813,68878142,10940.14978,16,1423313955,95.16072,7.185311
MINNESOTA_WADENA,1388950411,18009900,9218.404724,15,1406960311,98.719943,6.22529
MINNESOTA_WASECA,1096505110,24893715,7490.643372,11,1121398825,97.780119,6.964274
MINNESOTA_WASHINGTON,995618866,99457464,7403.402954,11,1095076330,90.91776,7.402898
MINNESOTA_WATONWAN,1126526388,12370135,7998.041748,12,1138896523,98.913849,6.738222
MINNESOTA_WILKIN,1945079889,482554,11401.42102,19,1945562443,99.975197,6.002237
MINNESOTA_WINONA,1621638207,40051890,13631.56732,20,1661690097,97.58969,6.984123
MINNESOTA_WRIGHT,1712289572,137612067,14324.47638,22,1849901639,92.561114,7.034407
MINNESOTA_YELLOW MEDICINE,1966062958,10687958,13823.09442,21,1976750916,99.459317,6.618209
MISSISSIPPI_ADAMS,1197464266,65273639,6601.192383,11,1262737905,94.830785,6.328202
MISSISSIPPI_ALCORN,1036110405,3408033,5341.72113,8,1039518438,99.672153,6.699114
MISSISSIPPI_AMITE,1890950865,3877823,12453.31982,20,1894828688,99.795347,6.239429
MISSISSIPPI_ATTALA,1903529290,4425860,13939.41541,21,1907955150,99.768031,6.65325
MISSISSIPPI_BENTON,1053131421,5279183,8074.251587,12,1058410604,99.501216,6.762272
MISSISSIPPI_BOLIVAR,2270541557,75515374,17420.00757,28,2346056931,96.781179,6.428348
MISSISSIPPI_CALHOUN,1519218284,3590388,12213.65955,18,1522808672,99.764226,6.801402
MISSISSIPPI_CARROLL,1627263542,16304134,10582.16309,16,1643567676,99.008003,6.680118
MISSISSIPPI_CHICKASAW,1299608407,6380767,8126.395447,12,1305989174,99.511423,6.805245
MISSISSIPPI_CHOCTAW,1083122611,4297811,9400.907715,14,1087420422,99.60477,6.741579
MISSISSIPPI_CLAIBORNE,1262400022,35711134,6761.63446,11,1298111156,97.248993,6.320827
MISSISSIPPI_CLARKE,1791177229,5069761,12549.58502,19,1796246990,99.717758,6.62374
MISSISSIPPI_CLAY,1062066001,15393112,7427.469238,11,1077459113,98.571351,6.850109
MISSISSIPPI_COAHOMA,1430939226,79418658,9371.82782,15,1510357884,94.741732,6.59465
MISSISSIPPI_COPIAH,2013158769,5644780,13873.23328,22,2018803549,99.72039,6.323697
MISSISSIPPI_COVINGTON,1071784947,2880713,6601.192017,10,1074665660,99.731943,6.618935
MISSISSIPPI_DESOTO,1233644242,53536481,8862.423889,14,1287180723,95.840795,6.605019
MISSISSIPPI_FORREST,1207042881,10872916,8548.558594,13,1217915797,99.107252,6.635049
MISSISSIPPI_FRANKLIN,1460658783,7250805,9275.562439,15,1467909588,99.506046,6.214405
MISSISSIPPI_GEORGE,1239816907,12838126,8320.93158,13,1252655033,98.975127,6.466995
MISSISSIPPI_GREENE,1845983328,15431185,13043.94763,20,1861414513,99.170997,6.576493
MISSISSIPPI_GRENADA,1093291104,70659566,9363.805542,14,1163950670,93.929333,7.120707
MISSISSIPPI_HANCOCK,1227561278,204095552,8085.281921,13,1431656830,85.744101,7.253499
MISSISSIPPI_HARRISON,1485725579,1064606460,8264.776855,13,2550332039,58.256163,10.913044
MISSISSIPPI_HINDS,2252849338,19297834,16189.617,26,2272147172,99.150679,6.280114
MISSISSIPPI_HOLMES,1959776826,20568825,12936.65192,20,1980345651,98.961352,6.536214
MISSISSIPPI_HUMPHREYS,1083947280,32942666,7569.861816,12,1116889946,97.0505,6.499934
MISSISSIPPI_ISSAQUENA,1069782879,73507456,8023.110962,13,1143290335,93.570535,6.595692
MISSISSIPPI_ITAWAMBA,1379933023,19825536,10749.6247,16,1399758559,98.583646,6.815041
MISSISSIPPI_JACKSON,1872035802,830366011,12011.10132,19,2702401813,69.273037,9.125675
MISSISSIPPI_JASPER,1751454613,3178416,11353.28821,17,1754633029,99.818856,6.690524
MISSISSIPPI_JEFFERSON,1346620554,18988092,9188.321777,15,1365608646,98.609551,6.211921
MISSISSIPPI_JEFFERSON DAVIS,1057871313,1791496,6555.065002,10,1059662809,99.830937,6.566166
MISSISSIPPI_JONES,1799554023,12681687,14646.36365,22,1812235710,99.300219,6.704354
MISSISSIPPI_KEMPER,1984403152,2182350,12985.78693,20,1986585502,99.890146,6.500034
MISSISSIPPI_LAFAYETTE,1636080566,123113358,13519.25745,20,1759193924,93.001718,7.268284
MISSISSIPPI_LAMAR,1286381289,8599922,9153.225159,14,1294981211,99.335904,6.581727
MISSISSIPPI_LAUDERDALE,1822508252,29730521,13035.92523,20,1852238773,98.394887,6.62429
MISSISSIPPI_LAWRENCE,1115254017,13188412,7821.555237,12,1128442429,98.831273,6.595041
MISSISSIPPI_LEAKE,1509697184,6376466,10608.23511,16,1516073650,99.579409,6.658151
MISSISSIPPI_LEE,1165404281,8314455,7429.474854,11,1173718736,99.291614,6.802254
MISSISSIPPI_LEFLORE,1538645698,31868197,11614.00671,18,1570513895,97.970843,6.585863
MISSISSIPPI_LINCOLN,1518269800,5291052,10878.9812,17,1523560852,99.652718,6.421702
MISSISSIPPI_LOWNDES,1309092521,28545194,7352.261902,11,1337637715,97.866,6.829619
MISSISSIPPI_MADISON,1850602740,71274123,12715.04108,20,1921876863,96.291431,6.602374
MISSISSIPPI_MARION,1404769586,16149945,9768.921997,15,1420919531,98.863416,6.587487
MISSISSIPPI_MARSHALL,1829011187,9173803,13945.43207,21,1838184990,99.500931,6.67399
MISSISSIPPI_MONROE,1981570208,18148644,12782.22638,19,1999718852,99.09244,6.789103
MISSISSIPPI_MONTGOMERY,1054074827,2352156,7402.400146,11,1056426983,99.777348,6.744471
MISSISSIPPI_NESHOBA,1476641125,3830971,10644.33478,16,1480472096,99.741233,6.669969
MISSISSIPPI_NEWTON,1496636747,4525334,10665.39252,16,1501162081,99.698545,6.686026
MISSISSIPPI_NOXUBEE,1800451925,12487951,11810.54834,18,1812939876,99.311177,6.606926
MISSISSIPPI_OKTIBBEHA,1186834313,9566078,9403.916077,14,1196400391,99.200428,6.771224
MISSISSIPPI_PANOLA,1774595250,51686997,10508.96137,16,1826282247,97.169824,6.759404
MISSISSIPPI_PEARL RIVER,2101267284,20822909,13946.43475,22,2122090193,99.018755,6.402109
MISSISSIPPI_PERRY,1676259645,7754347,11839.62842,18,1684013992,99.539532,6.607999
MISSISSIPPI_PIKE,1059350505,4341105,7046.41925,11,1063691610,99.591883,6.432086
MISSISSIPPI_PONTOTOC,1289201637,8437676,9480.12616,14,1297639313,99.349767,6.815837
MISSISSIPPI_PRENTISS,1074806616,8324262,8780.197205,13,1083130878,99.231463,6.806307
MISSISSIPPI_QUITMAN,1048975532,3676001,7024.358337,11,1052651533,99.650787,6.408158
MISSISSIPPI_RANKIN,2008522848,79229299,13504.21613,21,2087752147,96.205043,6.684243
MISSISSIPPI_SCOTT,1577902075,3001523,9942.400024,15,1580903598,99.810139,6.640875
MISSISSIPPI_SHARKEY,1118149686,8806463,7462.56604,12,1126956149,99.218562,6.267784
MISSISSIPPI_SIMPSON,1525930816,3378528,12303.90796,19,1529309344,99.779081,6.490079
MISSISSIPPI_SMITH,1647926089,2599432,11962.96851,18,1650525521,99.842509,6.656577
MISSISSIPPI_STONE,1153800122,6712351,7124.634644,11,1160512473,99.421605,6.514621
MISSISSIPPI_SUNFLOWER,1807187010,23747315,12091.32269,19,1830934325,98.702995,6.447478
MISSISSIPPI_TALLAHATCHIE,1671120103,17918953,11717.29144,18,1689039056,98.939104,6.579407
MISSISSIPPI_TATE,1048332513,16090912,7770.414246,12,1064423425,98.488298,6.574736
MISSISSIPPI_TIPPAH,1185754629,5522228,8809.277344,13,1191276857,99.536445,6.807926
MISSISSIPPI_TISHOMINGO,1098938846,52360190,10038.66553,15,1151299036,95.452077,7.011313
MISSISSIPPI_TUNICA,1177611241,67530029,6855.894043,11,1245141270,94.576517,6.590041
MISSISSIPPI_UNION,1076417872,3369003,7496.659912,11,1079786875,99.687994,6.836476
MISSISSIPPI_WALTHALL,1046169277,1236552,7143.687134,11,1047405829,99.881941,6.501937
MISSISSIPPI_WARREN,1524286571,77759836,9267.540527,15,1602046407,95.146218,6.493543
MISSISSIPPI_WASHINGTON,1879404534,92160904,13660.64734,22,1971565438,95.325496,6.513877
MISSISSIPPI_WAYNE,2099745598,7255476,13266.56091,20,2107001074,99.655649,6.656201
MISSISSIPPI_WEBSTER,1090760204,5398402,6754.615051,10,1096158606,99.507516,6.788045
MISSISSIPPI_WILKINSON,1756287127,25019144,10767.67389,18,1781306271,98.595461,6.067258
MISSISSIPPI_WINSTON,1572773189,7341897,11300.14197,17,1580115086,99.535357,6.678172
MISSISSIPPI_YALOBUSHA,1209914665,72140595,8046.174316,12,1282055260,94.373051,7.104936
MISSISSIPPI_YAZOO,2388847490,30612384,14515.00171,23,2419459874,98.734743,6.391742
MISSOURI_ADAIR,1469362058,5468507,11904.80817,18,1474830565,99.629211,6.638397
MISSOURI_ANDREW,1120509776,9678035,6966.19812,11,1130187811,99.143679,6.387606
MISSOURI_ATCHISON,1417462632,7359186,10727.56378,16,1424821818,99.483501,6.739537
MISSOURI_AUDRAIN,1792905920,11855681,12709.02448,19,1804761601,99.343089,6.733191
MISSOURI_BARRY,2015203933,32948669,11916.84094,20,2048152602,98.391298,6.055841
MISSOURI_BARTON,1533351029,12152201,8875.460327,15,1545503230,99.213706,5.963867
MISSOURI_BATES,2167029202,38034974,12306.91644,21,2205064176,98.275108,5.963297
MISSOURI_BENTON,1823462209,125581250,12146.47382,20,1949043459,93.556775,6.491499
MISSOURI_BOLLINGER,1600364571,8530122,11478.63397,18,1608894693,99.469815,6.411009
MISSOURI_BOONE,1775568659,14233911,10787.72968,17,1789802570,99.204722,6.396594
MISSOURI_BUCHANAN,1057347849,17956298,4917.552368,8,1075304147,98.330119,6.25133
MISSOURI_BUTLER,1799187755,11192416,11364.31885,19,1810380171,99.381764,6.018429
MISSOURI_CALDWELL,1104350538,8402195,7638.049622,12,1112752733,99.244918,6.413468
MISSOURI_CALLAWAY,2161518207,33189437,16309.94836,25,2194707644,98.487751,6.624153
MISSOURI_CAMDEN,1699143493,136285342,13849.16663,23,1835428835,92.574741,6.504341
MISSOURI_CAPE GIRARDEAU,1498414364,20158773,9416.952271,15,1518573137,98.672519,6.362428
MISSOURI_CARROLL,1799061892,17533392,11963.97156,19,1816595284,99.034821,6.358195
MISSOURI_CARTER,1314052439,4304986,7415.436218,12,1318357425,99.673458,6.199775
MISSOURI_CASS,1804223305,14963263,10134.9303,17,1819186568,99.177475,6.011167
MISSOURI_CEDAR,1228870880,62637821,7049.42749,12,1291508701,95.150027,6.173958
MISSOURI_CHARITON,1945541996,40353306,12122.40839,19,1985895302,97.968004,6.51255
MISSOURI_CHRISTIAN,1457250993,3004960,8321.934326,14,1460255953,99.794217,5.956496
MISSOURI_CLARK,1306924729,18695976,8781.200073,13,1325620705,98.589644,6.851398
MISSOURI_CLAY,1029948537,28501525,6102.818604,10,1058450062,97.30724,6.2717
MISSOURI_CLINTON,1085094819,11719847,6873.943787,11,1096814666,98.931465,6.316534
MISSOURI_COLE,1014104083,19106873,6131.898682,10,1033210956,98.150729,6.247431
MISSOURI_COOPER,1462703861,11467296,10530.01965,17,1474171157,99.222119,6.24269
MISSOURI_CRAWFORD,1923005893,3306284,14075.79157,22,1926312177,99.828362,6.409088
MISSOURI_DADE,1269121007,42072595,7679.16333,13,1311193602,96.791275,6.102873
MISSOURI_DALLAS,1401057571,4909181,7746.348022,13,1405966752,99.650832,5.979608
MISSOURI_DAVIESS,1458893649,14926594,10593.19348,16,1473820243,98.987217,6.688486
MISSOURI_DE KALB,1091311297,11561837,10297.37842,16,1102873134,98.951662,6.504046
MISSOURI_DENT,1949641178,4518782,15832.63312,25,1954159960,99.768761,6.347732
MISSOURI_DOUGLAS,2107274105,2520175,14242.24957,24,2109794280,99.880549,5.941368
MISSOURI_DUNKLIN,1401438398,15768936,8280.820862,14,1417207334,98.887323,5.981426
MISSOURI_FRANKLIN,2389655153,20808982,16661.91864,26,2410464135,99.136723,6.464234
MISSOURI_GASCONADE,1344216320,18008168,7122.629089,11,1362224488,98.678032,6.561863
MISSOURI_GENTRY,1272776755,762384,10507.95856,16,1273539139,99.940137,6.571408
MISSOURI_GREENE,1749088388,6612780,11903.80627,20,1755701168,99.623354,5.974406
MISSOURI_GRUNDY,1127401335,7118004,6631.275085,10,1134519339,99.372597,6.673143
MISSOURI_HARRISON,1871309893,10070644,12799.27332,19,1881380537,99.464721,6.772713
MISSOURI_HENRY,1805078265,91634021,11971.99335,20,1896712286,95.168797,6.289873
MISSOURI_HICKORY,1032908401,33454688,5344.72937,9,1066363089,96.86273,6.130932
MISSOURI_HOLT,1198369593,19839053,7524.737366,12,1218208646,98.371457,6.374425
MISSOURI_HOWARD,1201237134,19848483,8192.578003,13,1221085617,98.374522,6.406113
MISSOURI_HOWELL,2401562319,2913503,14129.94092,24,2404475822,99.87883,5.894618
MISSOURI_IRON,1425178293,4661906,7126.639893,11,1429840199,99.673956,6.499956
MISSOURI_JACKSON,1565689799,30629899,9027.880005,15,1596319698,98.081218,6.136329
MISSOURI_JASPER,1653723341,7163887,11902.80212,20,1660887228,99.568671,5.977182
MISSOURI_JEFFERSON,1700242389,20246517,10363.56055,16,1720488906,98.823211,6.554356
MISSOURI_JOHNSON,2147773696,10182862,12005.08466,20,2157956558,99.528125,6.031001
MISSOURI_KNOX,1305376627,7307094,7960.939453,12,1312683721,99.443347,6.671252
MISSOURI_LACLEDE,1980383097,8711544,10836.86572,18,1989094641,99.562035,6.046965
MISSOURI_LAFAYETTE,1627641077,27214232,9045.929565,15,1654855309,98.355492,6.131452
MISSOURI_LAWRENCE,1584393370,4247256,9537.283813,16,1588640626,99.732648,5.976781
MISSOURI_LEWIS,1308052629,14901560,11392.39606,17,1322954189,98.873615,6.777753
MISSOURI_LINCOLN,1622809699,35981661,10397.6546,16,1658791360,97.830851,6.642623
MISSOURI_LINN,1594366554,14989603,12934.64594,20,1609356157,99.068596,6.528126
MISSOURI_LIVINGSTON,1378657551,16187907,8435.246521,13,1394845458,98.839448,6.56484
MISSOURI_MACON,2075118025,28912941,14923.12616,23,2104030966,98.625831,6.578718
MISSOURI_MADISON,1280458107,8318260,9784.966125,15,1288776367,99.354561,6.565688
MISSOURI_MARIES,1364867202,7638777,8062.218262,13,1372505979,99.443443,6.236416
MISSOURI_MARION,1131623340,19113754,8709.000977,13,1150737094,98.338999,6.812385
MISSOURI_MCDONALD,1397247160,520251,8925.597412,15,1397767411,99.96278,5.952614
MISSOURI_MERCER,1175427727,3302140,8063.221191,12,1178729867,99.719856,6.738228
MISSOURI_MILLER,1534831730,19140601,9688.700928,16,1553972331,98.768279,6.130954
MISSOURI_MISSISSIPPI,1065995425,44494852,7876.707458,13,1110490277,95.993225,6.31191
MISSOURI_MONITEAU,1074917556,9954068,7333.209473,12,1084871624,99.082466,6.167598
MISSOURI_MONROE,1677427650,58291986,11317.18884,17,1735719636,96.641624,6.888512
MISSOURI_MONTGOMERY,1385765315,14100635,8609.727478,13,1399865950,98.992715,6.690257
MISSOURI_MORGAN,1547866664,42414965,10397.6546,17,1590281629,97.332865,6.283867
MISSOURI_NEW MADRID,1747873649,56238249,10901.04205,18,1804111898,96.882774,6.250992
MISSOURI_NEWTON,1618106494,4715004,8932.616943,15,1622821498,99.709456,5.97243
MISSOURI_NODAWAY,2271326614,2361588,15584.95007,24,2273688202,99.896134,6.500481
MISSOURI_OREGON,2045563487,4528610,11800.52094,20,2050092097,99.779102,5.913323
MISSOURI_OSAGE,1571034360,17734586,10827.84021,17,1588768946,98.883753,6.441218
MISSOURI_OZARK,1929467303,26575002,12748.13202,22,1956042305,98.641389,5.874416
MISSOURI_PEMISCOT,1275870101,53916744,8459.312561,14,1329786845,95.94546,6.297709
MISSOURI_PERRY,1228574132,25394864,9478.120728,15,1253968996,97.974841,6.449357
MISSOURI_PETTIS,1766953612,10501027,11060.48169,18,1777454639,99.40921,6.18123
MISSOURI_PHELPS,1739918996,6567069,11253.0119,18,1746486065,99.623984,6.275269
MISSOURI_PIKE,1736428533,36976721,13932.39606,21,1773405254,97.914931,6.775753
MISSOURI_PLATTE,1087240598,16991916,7899.771057,13,1104232514,98.461201,6.171717
MISSOURI_POLK,1646006161,17837927,9433.998962,16,1663844088,98.927909,5.960148
MISSOURI_PULASKI,1417013177,11314125,10947.16925,18,1428327302,99.207876,6.13032
MISSOURI_PUTNAM,1339843851,5943334,7971.969849,12,1345787185,99.558375,6.672777
MISSOURI_RALLS,1216742135,36381975,8056.201965,12,1253124110,97.096698,6.914243
MISSOURI_RANDOLPH,1250217888,13254191,9667.642761,15,1263472079,98.950971,6.513423
MISSOURI_RAY,1473209199,13278420,10420.71814,17,1486487619,99.106725,6.185084
MISSOURI_REYNOLDS,2093946392,15373678,14602.24243,23,2109320070,99.271155,6.395414
MISSOURI_RIPLEY,1630478460,5463304,10139.94458,17,1635941764,99.666045,5.984659
MISSOURI_SAINT CHARLES,1451718690,83246947,11121.64978,17,1534965637,94.576625,6.917298
MISSOURI_SAINT CLAIR,1748193269,70137865,13054.97839,22,1818331134,96.142734,6.172158
MISSOURI_SAINT FRANCOIS,1170381746,7216295,9108.100647,14,1177598041,99.387202,6.545899
MISSOURI_SAINT LOUIS,1314263296,40127127,9947.413818,15,1354390423,97.037256,6.850093
MISSOURI_SALINE,1956717081,29587349,14361.5791,23,1986304430,98.510432,6.338582
MISSOURI_SCHUYLER,795916404,2216011,5355.759705,8,798132415,99.72235,6.713339
MISSOURI_SCOTLAND,1130548363,7217862,8078.262939,12,1137766225,99.365611,6.774865
MISSOURI_SCOTT,1087772859,15192496,6781.689453,11,1102965355,98.622577,6.251279
MISSOURI_SHANNON,2599884451,464012,16048.22699,26,2600348463,99.982156,6.173497
MISSOURI_SHELBY,1297230221,3764606,6599.186462,10,1300994827,99.710636,6.618338
MISSOURI_STE. GENEVIEVE,1292800497,19739769,8339.984131,13,1312540266,98.496064,6.513329
MISSOURI_STODDARD,2132124564,15031652,13499.20239,22,2147156216,99.299927,6.17926
MISSOURI_STONE,1201446581,121045602,7751.362061,13,1322492183,90.847159,6.563316
MISSOURI_SULLIVAN,1678265048,9122602,11823.58429,18,1687387650,99.459365,6.604363
MISSOURI_TANEY,1637832031,49907618,11668.15595,20,1687739649,97.042931,6.011853
MISSOURI_TEXAS,3049103790,5071079,19082.58942,31,3054174869,99.833962,6.165912
MISSOURI_VERNON,2140343869,27020859,14633.32752,25,2167364728,98.753285,5.927227
MISSOURI_WARREN,1110087777,23730817,7708.243042,12,1133818594,97.907001,6.560855
MISSOURI_WASHINGTON,1968043952,6791224,14864.96564,23,1974835176,99.656112,6.485331
MISSOURI_WAYNE,1966281378,38535344,13913.34387,22,2004816722,98.077862,6.44819
MISSOURI_WEBSTER,1534731546,3109281,8966.71106,15,1537840827,99.797815,5.989918
MISSOURI_WORTH,690564983,493903,5317.654724,8,691058886,99.92853,6.651822
MISSOURI_WRIGHT,1765788214,3525240,12073.27246,20,1769313454,99.800757,6.048688
MONTANA_BEAVERHEAD,14355492109,78345289,55796.76907,154,14433837398,99.457211,3.64294
MONTANA_BIG HORN,12944280225,47395454,51620.25952,136,12991675679,99.635186,3.809505
MONTANA_BLAINE,10948196437,29079275,58601.49793,117,10977275712,99.735096,5.021978
MONTANA_BROADWATER,3088195834,118487318,14452.83014,34,3206683152,96.304988,4.413928
MONTANA_CARBON,5303530757,35410718,22207.20038,56,5338941475,99.336746,3.992049
MONTANA_CARTER,8651796239,19503322,44651.05252,94,8671299561,99.775082,4.76082
MONTANA_CASCADE,6988237754,34396942,31624.15213,76,7022634696,99.510199,4.181554
MONTANA_CHOUTEAU,10288824735,62565533,46891.22635,109,10351390268,99.395583,4.328107
MONTANA_CUSTER,9798723675,25612454,48990.01065,102,9824336129,99.739296,4.815496
MONTANA_DANIELS,3693365371,1021697,21675.73554,38,3694387068,99.972345,5.705719
MONTANA_DAWSON,6143238450,29905888,33083.17328,65,6173144338,99.515549,5.114496
MONTANA_DEER LODGE,1907999323,12199471,7661.113464,20,1920198794,99.364677,3.855049
MONTANA_FALLON,4197320394,5915331,21700.8049,44,4203235725,99.859267,4.938952
MONTANA_FERGUS,11238811024,27700320,58970.51511,117,11266511344,99.754136,5.052638
MONTANA_FLATHEAD,13175781006,437178481,66228.51785,142,13612959487,96.788513,4.818733
MONTANA_GALLATIN,6746958038,74488978,32947.79974,72,6821447016,98.908018,4.627369
MONTANA_GARFIELD,12112233259,446864356,59819.85605,129,12559097615,96.441907,4.808281
MONTANA_GLACIER,7756874927,106013590,35697.37766,82,7862888517,98.651722,4.412836
MONTANA_GOLDEN VALLEY,3041740578,2621792,15682.21845,34,3044362370,99.91388,4.616393
MONTANA_GRANITE,4473328964,14546368,17447.08231,46,4487875332,99.675874,3.805178
MONTANA_HILL,7508815833,44701997,32785.35266,78,7553517830,99.408196,4.228273
MONTANA_JEFFERSON,4291254981,6604351,17861.22348,45,4297859332,99.846334,3.975269
MONTANA_JUDITH BASIN,4842466678,2066739,23769.50574,50,4844533417,99.957339,4.75593
MONTANA_LAKE,3860290983,423545840,18502.99194,40,4283836823,90.112932,5.133279
MONTANA_LEWIS AND CLARK,8957164719,101496098,36733.23251,94,9058660817,98.879568,3.952071
MONTANA_LIBERTY,3703639182,44411469,16426.26901,41,3748050651,98.815078,4.054449
MONTANA_LINCOLN,9356423252,161590704,50552.31546,100,9518013956,98.302264,5.142538
MONTANA_MADISON,9293284427,39846408,40947.84744,97,9333130835,99.573065,4.239528
MONTANA_MCCONE,6843332002,103024638,37008.99222,73,6946356640,98.516854,5.146048
MONTANA_MEAGHER,6194909925,7475979,29874.3298,66,6202385904,99.879466,4.531876
MONTANA_MINERAL,3158799744,9897207,17356.83313,34,3168696951,99.687657,5.120946
MONTANA_MISSOULA,6715862371,64586516,30711.63754,71,6780448887,99.04746,4.367182
MONTANA_MUSSELSHELL,4840577745,7118682,22015.67264,51,4847696427,99.853153,4.323147
MONTANA_PARK,7258365000,27885027,35820.71726,77,7286250027,99.617292,4.669913
MONTANA_PETROLEUM,4288047862,48927318,20779.2652,44,4336975180,98.871856,4.776445
MONTANA_PHILLIPS,13313777226,185493125,75633.43561,142,13499270351,98.625903,5.400507
MONTANA_PONDERA,4207608384,43980663,15323.2291,44,4251589047,98.965548,3.518954
MONTANA_POWDER RIVER,8542288888,1565958,40719.21692,88,8543854846,99.981672,4.628032
MONTANA_POWELL,6024421096,16247901,25800.10248,65,6040668997,99.731025,3.979952
MONTANA_PRAIRIE,4497780202,15092932,23859.75476,48,4512873134,99.665558,4.987462
MONTANA_RAVALLI,6192655807,24208380,29523.36264,69,6216864187,99.610601,4.301559
MONTANA_RICHLAND,5398974500,49002599,29765.02814,58,5447977099,99.100536,5.17848
MONTANA_ROOSEVELT,6098391680,38582234,35060.62268,65,6136973914,99.371315,5.428067
MONTANA_ROSEBUD,12971010158,44234236,58960.48792,140,13015244394,99.660135,4.225826
MONTANA_SANDERS,7149405173,76394142,39568.04489,77,7225799315,98.942759,5.193616
MONTANA_SHERIDAN,4340323253,75007243,26935.23023,50,4415330496,98.301209,5.480142
MONTANA_SILVER BOW,1859568275,1518176,8120.379059,21,1861086451,99.918425,3.870004
MONTANA_STILLWATER,4653551002,23732517,22458.89386,52,4677283519,99.4926,4.341044
MONTANA_SWEET GRASS,4805735230,17537143,22080.85233,49,4823272373,99.636406,4.522741
MONTANA_TETON,5883425281,52657848,21803.08691,61,5936083129,99.112919,3.606267
MONTANA_TOOLE,4959868815,78026225,18259.32062,53,5037895040,98.451214,3.499352
MONTANA_TREASURE,2532492070,17149961,10187.07437,25,2549642031,99.327358,4.102424
MONTANA_VALLEY,12758539633,351469571,74769.05472,136,13110009204,97.319075,5.649175
MONTANA_WHEATLAND,3684208403,13010925,18736.6358,39,3697219328,99.648089,4.821232
MONTANA_WIBAUX,2303979500,1756846,11684.20026,23,2305736346,99.923805,5.083961
MONTANA_YELLOWSTONE,6820664370,39931163,28757.25156,73,6860595533,99.417964,3.962412
NEBRASKA_ADAMS,1458872841,2477677,9615.499634,17,1461350518,99.830453,5.665782
NEBRASKA_ANTELOPE,2220025598,3716666,14179.0755,24,2223742264,99.832864,5.917839
NEBRASKA_ARTHUR,1852759730,7644718,8550.564301,19,1860404448,99.589083,4.518866
NEBRASKA_BANNER,1932676688,397069,7694.204376,19,1933073757,99.979459,4.050413
NEBRASKA_BLAINE,1840673981,9443894,10730.57233,20,1850117875,99.489552,5.392814
NEBRASKA_BOONE,1778166040,1718583,10102.8421,17,1779884623,99.903444,5.948592
NEBRASKA_BOX BUTTE,2784994713,6588657,11479.63641,29,2791583370,99.763981,3.96786
NEBRASKA_BOYD,1398424239,11893557,8839.359924,16,1410317796,99.156675,5.571587
NEBRASKA_BROWN,3163296263,9814399,17420.00775,33,3173110662,99.690701,5.295168
NEBRASKA_BUFFALO,2507679136,18593314,16780.24457,30,2526272450,99.264002,5.634888
NEBRASKA_BURT,1273201348,14186270,7050.430298,10,1287387618,98.898058,7.128988
NEBRASKA_BUTLER,1514886625,15307372,10665.39264,16,1530193997,98.999645,6.733227
NEBRASKA_CASS,1443537055,22114724,12934.64636,18,1465651779,98.491134,7.296002
NEBRASKA_CEDAR,1917219995,14513818,12941.66565,21,1931733813,99.248664,6.209351
NEBRASKA_CHASE,2316533450,7978172,11274.06995,24,2324511622,99.656781,4.713707
NEBRASKA_CHERRY,15436868249,127452878,80542.96622,162,15564321127,99.181122,5.015149
NEBRASKA_CHEYENNE,3098367766,292549,15074.54352,35,3098660315,99.990559,4.307419
NEBRASKA_CLAY,1482222907,3234877,9146.206116,16,1485457784,99.78223,5.728855
NEBRASKA_COLFAX,1066160352,12611464,7359.281311,11,1078771816,98.830942,6.769394
NEBRASKA_CUMING,1477652222,10690952,10934.13342,16,1488343174,99.281688,6.883277
NEBRASKA_CUSTER,6670757258,932956,38441.94171,72,6671690214,99.986016,5.339905
NEBRASKA_DAKOTA,684463003,8152947,5914.299255,9,692615950,98.822876,6.649719
NEBRASKA_DAWES,3616875592,11870270,16577.68601,40,3628745862,99.672882,4.158023
NEBRASKA_DAWSON,2623887235,16431843,15443.56067,29,2640319078,99.377657,5.358715
NEBRASKA_DEUEL,1139209085,2230956,5026.853363,12,1141440041,99.804549,4.197248
NEBRASKA_DIXON,1233119999,17111893,7034.385925,11,1250231892,98.631302,6.472855
NEBRASKA_DODGE,1370269383,36091878,7912.806702,11,1406361261,97.433669,7.388623
NEBRASKA_DOUGLAS,845399899,33504581,5916.304626,8,878904480,96.187916,7.688472
NEBRASKA_DUNDY,2381956151,3046331,11242.98422,24,2385002482,99.872271,4.690568
NEBRASKA_FILLMORE,1490202782,2989990,7004.302795,12,1493192772,99.799759,5.84863
NEBRASKA_FRANKLIN,1491355860,487899,8875.459595,16,1491843759,99.967296,5.548977
NEBRASKA_FRONTIER,2524283299,14110075,13667.6662,27,2538393374,99.444134,5.090394
NEBRASKA_FURNAS,1862542306,3915843,10193.09076,20,1866458149,99.790199,5.10726
NEBRASKA_GAGE,2205275202,22010739,15123.67896,24,2227285941,99.011769,6.364428
NEBRASKA_GARDEN,4417083924,65860691,18394.6937,46,4482944615,98.530861,4.058471
NEBRASKA_GARFIELD,1474558345,5321553,9037.90741,16,1479879898,99.640406,5.669078
NEBRASKA_GOSPER,1186616237,11831826,6828.819397,13,1198448063,99.012738,5.305315
NEBRASKA_GRANT,2012081437,16460163,9362.802612,20,2028541600,99.188572,4.719698
NEBRASKA_GREELEY,1475804204,2188872,9429.987671,16,1477993076,99.851902,5.902484
NEBRASKA_HALL,1415146251,14900901,9208.377869,16,1430047152,98.958013,5.815836
NEBRASKA_HAMILTON,1403509086,7360261,10674.41724,18,1410869347,99.478317,5.961331
NEBRASKA_HARLAN,1433471255,53339808,8469.340332,16,1486811063,96.412469,5.490304
NEBRASKA_HAYES,1846821518,570786,9780.955139,20,1847392304,99.969103,4.891989
NEBRASKA_HITCHCOCK,1838742723,22103381,9751.875031,20,1860846104,98.812187,4.934551
NEBRASKA_HOLT,6248078943,13204318,37911.47968,67,6261283261,99.789112,5.670388
NEBRASKA_HOOKER,1867796142,882994,9786.97168,20,1868679136,99.952748,4.895799
NEBRASKA_HOWARD,1474578450,16199402,8837.354309,15,1490777852,98.913359,5.956293
NEBRASKA_JEFFERSON,1476736210,14232352,9446.032104,16,1490968562,99.045429,5.960669
NEBRASKA_JOHNSON,974023321,1711433,8026.119019,12,975734754,99.824601,6.700185
NEBRASKA_KEARNEY,1337063538,274634,6739.573059,12,1337338172,99.979464,5.617464
NEBRASKA_KEITH,2749531879,124672190,13496.19394,30,2874204069,95.662375,4.702718
NEBRASKA_KEYA PAHA,2002257565,2192458,10476.87274,20,2004450023,99.89062,5.244172
NEBRASKA_KIMBALL,2465269087,1448446,11549.82993,26,2466717533,99.94128,4.444852
NEBRASKA_KNOX,2870854403,81011709,20042.2334,34,2951866112,97.255576,6.061117
NEBRASKA_LANCASTER,2169270569,22849484,16345.04511,24,2192120053,98.957654,6.882172
NEBRASKA_LINCOLN,6641072809,28449819,35219.05942,72,6669522628,99.573435,4.912491
NEBRASKA_LOGAN,1478003936,1203586,8122.384064,16,1479207522,99.918633,5.080624
NEBRASKA_LOUP,1459513669,19565477,8714.014587,16,1479079146,98.677185,5.519269
NEBRASKA_MADISON,1483084606,7325865,9602.463135,16,1490410471,99.508467,6.031185
NEBRASKA_MCPHERSON,2224733578,2680669,11369.33249,24,2227414247,99.879651,4.74293
NEBRASKA_MERRICK,1258350331,28301100,6695.451965,11,1286651431,97.800407,6.22367
NEBRASKA_MORRILL,3687721317,15601327,14442.8031,37,3703322644,99.578721,3.919974
NEBRASKA_NANCE,1143733235,17178940,8612.735718,14,1160912175,98.520221,6.244357
NEBRASKA_NEMAHA,1055100614,5769942,6787.705994,10,1060870556,99.456113,6.824825
NEBRASKA_NUCKOLLS,1489645188,1718484,7317.165039,13,1491363672,99.884771,5.635082
NEBRASKA_OTOE,1594561663,8689332,11748.37732,17,1603250995,99.458018,6.94847
NEBRASKA_PAWNEE,1116478180,4852361,7452.538391,12,1121330541,99.567268,6.23744
NEBRASKA_PERKINS,2287828027,2840176,10186.07144,22,2290668203,99.876011,4.63578
NEBRASKA_PHELPS,1398048600,1646533,7060.457764,13,1399695133,99.882365,5.437518
NEBRASKA_PIERCE,1484707285,3481943,9661.626282,16,1488189228,99.766028,6.052678
NEBRASKA_PLATTE,1745910556,27167484,11189.83807,18,1773078040,98.467778,6.313311
NEBRASKA_POLK,1135309851,5947393,8846.3797,14,1141257244,99.478874,6.351944
NEBRASKA_RED WILLOW,1857036396,2591016,9865.187317,20,1859627412,99.86067,4.939476
NEBRASKA_RICHARDSON,1429261307,7077613,10180.05518,16,1436338920,99.507246,6.394041
NEBRASKA_ROCK,2611466193,8807741,14473.88849,27,2620273934,99.663862,5.37878
NEBRASKA_SALINE,1486812294,5821039,9759.89679,16,1492633333,99.610015,6.123817
NEBRASKA_SARPY,616811568,24272925,5119.107544,7,641084493,96.213771,7.600794
NEBRASKA_SAUNDERS,1940652995,27272221,15124.68189,21,1967925216,98.614164,7.303443
NEBRASKA_SCOTTS BLUFF,1915079305,15397684,8678.91806,23,1930476989,99.20239,3.803782
NEBRASKA_SEWARD,1479995666,11542537,7680.165527,12,1491538203,99.226132,6.450053
NEBRASKA_SHERIDAN,6322057037,74718659,28358.15155,66,6396775696,98.831932,4.352092
NEBRASKA_SHERMAN,1465489225,15062151,9047.935364,16,1480551376,98.982666,5.713081
NEBRASKA_SIOUX,5352724896,1681023,22430.81665,57,5354405919,99.968605,3.936467
NEBRASKA_STANTON,1107500697,8789497,7624.010803,12,1116290194,99.212615,6.403765
NEBRASKA_THAYER,1486153245,3025339,8531.512207,15,1489178584,99.796845,5.699253
NEBRASKA_THOMAS,1846403702,2028433,10331.47211,20,1848432135,99.890262,5.171411
NEBRASKA_THURSTON,1019377259,6458662,7470.587952,11,1025835921,99.3704,6.834473
NEBRASKA_VALLEY,1471402793,6076916,9015.84668,16,1477479709,99.588697,5.658176
NEBRASKA_WASHINGTON,1009985093,8388605,9576.391479,13,1018373698,99.176274,7.436583
NEBRASKA_WAYNE,1147147009,1084590,6967.200806,11,1148231599,99.905543,6.339807
NEBRASKA_WEBSTER,1489017962,337241,8993.785645,16,1489355203,99.977357,5.622389
NEBRASKA_WHEELER,1489717866,1059454,9332.719543,16,1490777320,99.928933,5.837098
NEBRASKA_YORK,1482794061,8595052,9748.866699,16,1491389113,99.423688,6.12836
NEVADA_CARSON CITY,374670880,32586219,1379.802521,4,407257099,91.998612,3.74952
NEVADA_CHURCHILL,12821785223,190748448,17530.31123,137,13012533671,98.534118,1.298621
NEVADA_CLARK,20439276974,438416032,28955.79848,218,20877693006,97.900074,1.356738
NEVADA_DOUGLAS,1838170319,72317573,6438.744446,19,1910487892,96.214707,3.522136
NEVADA_ELKO,44479019136,74784739,80753.54681,470,44553803875,99.832147,1.721049
NEVADA_ESMERALDA,9277049964,18552010,10298.38095,98,9295601974,99.800422,1.052957
NEVADA_EUREKA,10814982421,11058701,19607.03456,114,10826041122,99.897851,1.721674
NEVADA_HUMBOLDT,24969533319,44196978,53144.45931,261,25013730297,99.823309,2.041667
NEVADA_LANDER,14294783154,662270,26051.79569,152,14295445424,99.995367,1.714013
NEVADA_LINCOLN,27540342245,9802713,48936.8642,290,27550144958,99.964419,1.688079
NEVADA_LYON,5183173264,59602530,12207.64278,54,5242775794,98.863149,2.286671
NEVADA_MINERAL,9719815181,155746679,16952.71965,103,9875561860,98.422908,1.672268
NEVADA_NYE,47090939040,43207981,70168.37602,499,47134147021,99.90833,1.40747
NEVADA_PERSHING,15634691964,79934815,25803.11014,166,15714626779,99.491335,1.562351
NEVADA_STOREY,683680818,1881020,1704.697983,7,685561838,99.725624,2.441983
NEVADA_WASHOE,16358779479,582737537,50001.79871,175,16941517016,96.560299,2.960993
NEVADA_WHITE PINE,23016356483,23426584,38266.45783,242,23039783067,99.898321,1.582868
NEW HAMPSHIRE_BELKNAP,1040771458,176549424,6827.81665,11,1217320882,85.496887,7.260037
NEW HAMPSHIRE_CARROLL,2413511287,159624444,16462.36829,27,2573135731,93.796501,6.500427
NEW HAMPSHIRE_CHESHIRE,1830367250,57589034,11882.74762,19,1887956284,96.949663,6.45085
NEW HAMPSHIRE_COOS,4647923684,92553609,29861.29474,50,4740477293,98.047589,6.091184
NEW HAMPSHIRE_GRAFTON,4425254602,106459251,29098.19208,48,4531713853,97.650795,6.208953
NEW HAMPSHIRE_HILLSBOROUGH,2270197483,41314379,16399.19434,26,2311511862,98.212669,6.422168
NEW HAMPSHIRE_MERRIMACK,2416153059,57222878,18150.01965,29,2473375937,97.686446,6.406853
NEW HAMPSHIRE_ROCKINGHAM,1801042583,258639091,11478.63379,18,2059681674,87.442764,7.292792
NEW HAMPSHIRE_STRAFFORD,951745163,39159595,6343.481934,10,990904758,96.048097,6.604485
NEW HAMPSHIRE_SULLIVAN,1392231686,37791729,9383.860962,15,1430023415,97.357265,6.425722
NEW JERSEY_ATLANTIC,1438776649,301268696,7452.538391,12,1740045345,82.686158,7.510869
NEW JERSEY_BERGEN,602911111,35354979,4533.493652,7,638266090,94.460777,6.8562
NEW JERSEY_BURLINGTON,2070157741,54113400,13727.83252,22,2124271141,97.452613,6.403034
NEW JERSEY_CAMDEN,573293905,15720557,4362.021362,7,589014462,97.331041,6.402335
NEW JERSEY_CAPE MAY,651338862,955248161,3748.330017,6,1606587023,40.541773,15.409333
NEW JERSEY_CUMBERLAND,1251898273,503713107,8832.341064,14,1755611380,71.308394,8.847226
NEW JERSEY_ESSEX,326557454,8638174,2275.402189,3.532872,335195628,97.422946,6.611032
NEW JERSEY_GLOUCESTER,833916105,38320616,6264.263733,10,872236721,95.606627,6.552123
NEW JERSEY_HUDSON,119640830,41958705,1919.289368,3,161599535,74.03538,8.65486
NEW JERSEY_HUNTERDON,1108076939,24770921,8367.058472,13,1132847860,97.813394,6.580079
NEW JERSEY_MERCER,581297755,11434826,3172.743774,5,592732581,98.070829,6.470311
NEW JERSEY_MIDDLESEX,800864377,35466050,5104.066345,8,836330427,95.759326,6.662623
NEW JERSEY_MONMOUTH,1212585319,510987402,7602.952942,12,1723572721,70.353012,9.005718
NEW JERSEY_MORRIS,1193878537,53263498,9721.791931,15,1247142035,95.729155,6.770346
NEW JERSEY_OCEAN,1627387052,742027591,8764.153198,14,2369414643,68.683084,9.114485
NEW JERSEY_PASSAIC,481767296,32057602,3876.683655,6,513824898,93.760987,6.891074
NEW JERSEY_SALEM,859517464,105387382,4424.192566,7,964904846,89.077951,7.095218
NEW JERSEY_SOMERSET,781830431,7994903,5785.945313,9,789825334,98.987763,6.494569
NEW JERSEY_SUSSEX,1343564828,43222888,9758.894165,15,1386787716,96.883237,6.715227
NEW JERSEY_UNION,266163527,7053423,1924.303101,3,273216950,97.41838,6.584326
NEW JERSEY_WARREN,923424386,15834476,6524.982056,10,939258862,98.314152,6.63687
NEW MEXICO_BERNALILLO,3007645106,15849400,4909.529907,30,3023494506,99.475792,1.645134
NEW MEXICO_CATRON,17933559836,14195265,57062.25688,192,17947755101,99.920908,2.974345
NEW MEXICO_CHAVES,15713907540,20479488,27220.01505,162,15734387028,99.869842,1.682438
NEW MEXICO_CIBOLA,11758505180,5554603,30864.05798,124,11764059783,99.952783,2.490213
NEW MEXICO_COLFAX,9733110165,26299632,36350.17706,105,9759409797,99.73052,3.471276
NEW MEXICO_CURRY,3640261520,8027146,13514.24362,41,3648288666,99.779975,3.303425
NEW MEXICO_DE BACA,6016819475,29089486,13391.90649,65,6045908961,99.518857,2.070254
NEW MEXICO_DONA ANA,9863164217,17589892,8841.365845,103,9880754109,99.821978,0.859916
NEW MEXICO_EDDY,10816683024,56498061,15949.95619,116,10873181085,99.480391,1.382178
NEW MEXICO_GRANT,10259475126,15298388,20033.20909,108,10274773514,99.851107,1.857693
NEW MEXICO_GUADALUPE,7847072129,2887948,15517.76524,84,7849960077,99.963211,1.848033
NEW MEXICO_HARDING,5504963123,1162620,17016.89652,58,5506125743,99.978885,2.934567
NEW MEXICO_HIDALGO,8905760686,23582051,12927.62689,92,8929342737,99.735904,1.408898
NEW MEXICO_LEA,11373854756,8356103,23922.92871,119,11382210859,99.926586,2.011807
NEW MEXICO_LINCOLN,12512530057,554839,18816.85709,134,12513084896,99.995566,1.404305
NEW MEXICO_LOS ALAMOS,282843396,208105,502.384537,2,283051501,99.926478,2.513771
NEW MEXICO_LUNA,7679776973,433660,8026.119034,82,7680210633,99.994354,0.97885
NEW MEXICO_MCKINLEY,14117193195,13684636,30702.61253,149,14130877831,99.903158,2.062575
NEW MEXICO_MORA,4988962825,6093304,18275.36499,53,4995056129,99.878013,3.452394
NEW MEXICO_OTERO,17126456785,36943378,26265.38408,182,17163400163,99.784755,1.446266
NEW MEXICO_QUAY,7443508573,18554572,25580.49674,78,7462063145,99.751348,3.287726
NEW MEXICO_RIO ARRIBA,15179590198,91466278,49665.87306,163,15271056476,99.401048,3.065346
NEW MEXICO_ROOSEVELT,6335242828,18679735,19302.19475,67,6353922563,99.706013,2.889419
NEW MEXICO_SAN JUAN,14289491641,54966780,24200.69412,152,14344458421,99.616808,1.598275
NEW MEXICO_SAN MIGUEL,12228666254,51380263,31747.49194,127,12280046517,99.581596,2.510306
NEW MEXICO_SANDOVAL,9609141717,10852111,26384.71309,104,9619993828,99.887192,2.539857
NEW MEXICO_SANTA FE,4947856149,2648084,11645.09245,52,4950504233,99.946509,2.240639
NEW MEXICO_SIERRA,10829248654,147675972,17030.93525,115,10976924626,98.654669,1.501146
NEW MEXICO_SOCORRO,17214061650,4843011,28868.55829,178,17218904661,99.971874,1.622285
NEW MEXICO_TAOS,5704119383,3383128,16069.28505,58,5707502511,99.940725,2.77221
NEW MEXICO_TORRANCE,8664061332,2316559,14217.18086,90,8666377891,99.97327,1.580109
NEW MEXICO_UNION,9906866302,15466855,34398.79907,104,9922333157,99.844121,3.312741
NEW MEXICO_VALENCIA,2762854204,2760089,4394.109787,30,2765614293,99.9002,1.466166
NEW YORK_ALBANY,1354120788,27124553,9536.281189,15,1381245341,98.036225,6.484869
NEW YORK_ALLEGANY,2666029673,12999275,17683.73462,28,2679028948,99.514777,6.346414
NEW YORK_BRONX,108909571,39687923,1292.562134,2,148597494,73.291661,8.817935
NEW YORK_BROOME,1828061552,25111002,11707.26367,18,1853172554,98.644972,6.593377
NEW YORK_CATTARAUGUS,3388424412,36817330,22847.96643,36,3425241742,98.925117,6.415618
NEW YORK_CAYUGA,1791190510,445708165,12787.24048,20,2236898675,80.074727,7.984567
NEW YORK_CHAUTAUQUA,2746047476,1139407865,19220.97064,30,3885455341,70.675049,9.06542
NEW YORK_CHEMUNG,1055038227,8874756,6431.724792,10,1063912983,99.165838,6.485827
NEW YORK_CHENANGO,2314393900,13046917,16254.79602,25,2327440817,99.439431,6.538572
NEW YORK_CLINTON,2687779168,206603306,17400.95514,28,2894382474,92.861921,6.692331
NEW YORK_COLUMBIA,1643770776,35071400,10906.0556,17,1678842176,97.910977,6.552204
NEW YORK_CORTLAND,1291815777,7112822,9617.504883,15,1298928599,99.452409,6.446973
NEW YORK_DELAWARE,3735857754,64812298,26135.02448,40,3800670052,98.294714,6.647108
NEW YORK_DUTCHESS,2060720815,76913736,14253.27997,22,2137634551,96.401923,6.720575
NEW YORK_ERIE,2700648539,476891055,17918.38147,29,3177539594,84.991814,7.26982
NEW YORK_ESSEX,4646744234,316359504,29453.16962,48,4963103738,93.625773,6.553833
NEW YORK_FRANKLIN,4219644200,176695862,28552.68756,47,4396340062,95.980842,6.32943
NEW YORK_FULTON,1283234678,96916405,8180.544617,13,1380151083,92.977841,6.767985
NEW YORK_GENESEE,1276705469,6137411,8634.796448,14,1282842880,99.521577,6.197361
NEW YORK_GREENE,1676140495,28201061,12148.48023,19,1704341556,98.34534,6.501515
NEW YORK_HAMILTON,4447989353,234204421,30704.61835,50,4682193774,94.997977,6.464268
NEW YORK_HERKIMER,3655873433,120354579,24578.73651,39,3776228012,96.812836,6.509715
NEW YORK_JEFFERSON,3285923214,1524610949,20933.69092,34,4810534163,68.306826,9.013693
NEW YORK_KINGS,179671310,71098973,1064.935645,1.666886,250770283,71.647768,8.918338
NEW YORK_LEWIS,3301307122,39612947,21131.23554,34,3340920069,98.81431,6.289645
NEW YORK_LIVINGSTON,1636254768,22005357,11360.3078,18,1658260125,98.672985,6.39616
NEW YORK_MADISON,1696048608,16696751,10833.85693,17,1712745359,99.025147,6.435595
NEW YORK_MONROE,1701280157,1838466355,10093.81763,16,3539746512,48.062203,13.125982
NEW YORK_MONTGOMERY,1044066970,18599188,6987.256165,11,1062666158,98.249762,6.465208
NEW YORK_NASSAU,737195890,437275916,4509.427368,7,1174471806,62.768292,10.263206
NEW YORK_NEW YORK,58690498,28541727,590.130682,0.919404,87232225,67.280753,9.542897
NEW YORK_NIAGARA,1352887561,1598842375,8402.155457,14,2951729936,45.833718,13.094158
NEW YORK_ONEIDA,3139921947,117357163,22028.70886,35,3257279110,96.39708,6.529157
NEW YORK_ONONDAGA,2016013104,70527533,14651.37793,23,2086540637,96.619882,6.593016
NEW YORK_ONTARIO,1668081009,47854414,11544.81604,18,1715935423,97.211176,6.597787
NEW YORK_ORANGE,2103886749,68105750,14287.37421,22,2171992499,96.864365,6.704489
NEW YORK_ORLEANS,1013366843,1103741897,5510.185669,9,2117108740,47.865602,12.790873
NEW YORK_OSWEGO,2464751381,933476015,15090.5882,24,3398227396,72.530502,8.669105
NEW YORK_OTSEGO,2594487145,36314099,18149.01599,28,2630801244,98.619656,6.572515
NEW YORK_PUTNAM,596542964,41243959,5248.464233,8,637786923,93.53327,7.014168
NEW YORK_QUEENS,281734463,179364919,1282.534546,2,461099382,61.100594,10.495271
NEW YORK_RENSSELAER,1689852106,33533280,10178.04981,16,1723385386,98.05422,6.487514
NEW YORK_RICHMOND,148976885,115948458,554.160781,0.867729,264925343,56.233535,11.356624
NEW YORK_ROCKLAND,449218387,66842906,3918.799744,6,516061293,87.047487,7.503184
NEW YORK_SAINT LAWRENCE,6939877189,367298360,43864.88702,71,7307175549,94.973456,6.505137
NEW YORK_SARATOGA,2097879145,87573063,13733.84912,22,2185452208,95.992909,6.50325
NEW YORK_SCHENECTADY,529862595,12594061,3784.429504,6,542456656,97.678329,6.4573
NEW YORK_SCHOHARIE,1610503569,11676951,10264.28705,16,1622180520,99.280169,6.461693
NEW YORK_SCHUYLER,850405405,36246373,6406.65625,10,886651778,95.911995,6.679724
NEW YORK_SENECA,838403628,172828921,6422.699951,10,1011232549,82.909082,7.746678
NEW YORK_STEUBEN,3601520291,35040141,24865.52679,39,3636560432,99.036448,6.437808
NEW YORK_SUFFOLK,2361568402,3784825485,12115.38879,19,6146393887,38.422015,16.596007
NEW YORK_SULLIVAN,2507463739,74034521,17579.44684,27,2581498260,97.13211,6.703145
NEW YORK_TIOGA,1343194530,11058001,9660.62323,15,1354252531,99.183461,6.493437
NEW YORK_TOMPKINS,1229314959,43787671,8969.719849,14,1273102630,96.560555,6.635155
NEW YORK_ULSTER,2911757960,94596776,20006.13409,31,3006354736,96.853439,6.663255
NEW YORK_WARREN,2246082355,166754989,16608.77197,27,2412837344,93.088843,6.608093
NEW YORK_WASHINGTON,2152713603,38126958,15707.2876,25,2190840561,98.259711,6.394192
NEW YORK_WAYNE,1563912968,2018185132,10277.32282,16,3582098100,43.659133,14.712447
NEW YORK_WESTCHESTER,1115219580,179756608,7853.643677,12,1294976188,86.118926,7.599611
NEW YORK_WYOMING,1535219547,9158065,9983.513367,16,1544377612,99.407006,6.276918
NEW YORK_YATES,875801459,97489006,5768.898315,9,973290465,89.983565,7.123397
NORTH CAROLINA_ALAMANCE,1096718106,27958505,7184.800293,11,1124676611,97.514085,6.698147
NORTH CAROLINA_ALEXANDER,673358168,9445988,5161.223755,8,682804156,98.616589,6.542033
NORTH CAROLINA_ALLEGHANY,607139719,3676325,3905.763794,6,610816044,99.398129,6.549023
NORTH CAROLINA_ANSON,1376478136,14603213,9154.227844,14,1391081349,98.950226,6.608104
NORTH CAROLINA_ASHE,1100930108,8064800,7956.928162,12,1108994908,99.272783,6.679347
NORTH CAROLINA_AVERY,640602134,445285,5469.072388,8,641047419,99.930538,6.841092
NORTH CAROLINA_BEAUFORT,2155109574,338655073,14479.90503,20,2493764647,86.419926,8.380085
NORTH CAROLINA_BERTIE,1810858586,109088136,13587.44531,19,1919946722,94.318169,7.582088
NORTH CAROLINA_BLADEN,2265887723,33010866,16785.25824,24,2298898589,98.564057,7.095748
NORTH CAROLINA_BRUNSWICK,2199399191,518904287,16187.6109,23,2718303478,80.91073,8.698589
NORTH CAROLINA_BUNCOMBE,1700318985,8942803,12375.10468,18,1709261788,99.476803,6.911217
NORTH CAROLINA_BURKE,1311146877,20719896,9264.532104,14,1331866773,98.444297,6.722099
NORTH CAROLINA_CABARRUS,935650180,7005427,6160.978821,10,942655607,99.256841,6.207107
NORTH CAROLINA_CALDWELL,1222192494,7038403,7335.214966,11,1229230897,99.427414,6.706779
NORTH CAROLINA_CAMDEN,622448680,181112906,4971.701477,7,803561586,77.461229,9.169014
NORTH CAROLINA_CARTERET,1314684783,2131065796,5005.79541,7,3445750579,38.1538,18.74292
NORTH CAROLINA_CASWELL,1101694778,8641803,6853.888428,11,1110336581,99.221695,6.279683
NORTH CAROLINA_CATAWBA,1039550834,37945134,7555.822998,12,1077495968,96.478397,6.526351
NORTH CAROLINA_CHATHAM,1765648430,70626784,12312.93329,18,1836275214,96.153802,7.114143
NORTH CAROLINA_CHEROKEE,1179845619,28813485,8211.630249,12,1208659104,97.616078,7.010141
NORTH CAROLINA_CHOWAN,447179930,157966162,3567.832581,5,605146092,73.896194,9.656337
NORTH CAROLINA_CLAY,556804505,15017755,4175.507324,6,571822260,97.373702,7.146877
NORTH CAROLINA_CLEVELAND,1202311340,10177696,6836.841492,11,1212489036,99.160595,6.267924
NORTH CAROLINA_COLUMBUS,2429722359,43711694,17955.48328,26,2473434053,98.232753,7.030196
NORTH CAROLINA_CRAVEN,1830014535,172777667,14453.83325,20,2002792202,91.373161,7.909234
NORTH CAROLINA_CUMBERLAND,1690129718,15279291,12532.53851,18,1705409009,99.104069,7.025465
NORTH CAROLINA_CURRITUCK,678350084,685089722,1423.924194,2,1363439806,49.752844,14.309978
NORTH CAROLINA_DARE,992557887,3000513932,4953.65155,7,3993071819,24.857001,28.469425
NORTH CAROLINA_DAVIDSON,1432727271,37436736,9448.037781,15,1470164007,97.453567,6.463275
NORTH CAROLINA_DAVIE,682965396,7401507,3742.313416,6,690366903,98.927888,6.304783
NORTH CAROLINA_DUPLIN,2110215814,14137851,16607.76904,23,2124353665,99.334487,7.269146
NORTH CAROLINA_DURHAM,741994332,29467007,6646.316528,10,771461339,96.180365,6.910263
NORTH CAROLINA_EDGECOMBE,1309064804,3715266,11470.61188,16,1312780070,99.716993,7.189479
NORTH CAROLINA_FORSYTH,1056221627,11712626,6872.941162,11,1067934253,98.903245,6.317415
NORTH CAROLINA_FRANKLIN,1273757138,7178583,10230.19342,15,1280935721,99.439583,6.858566
NORTH CAROLINA_GASTON,921386282,20552442,7226.916199,12,941938724,97.81807,6.156766
NORTH CAROLINA_GATES,882181716,13292008,6348.495544,9,895473724,98.515645,7.160166
NORTH CAROLINA_GRAHAM,756189024,25057776,5356.762634,8,781246800,96.792592,6.917837
NORTH CAROLINA_GRANVILLE,1377850155,14503653,9763.908142,15,1392353808,98.958336,6.577791
NORTH CAROLINA_GREENE,690839648,1228821,5852.127869,8,692068469,99.822442,7.328172
NORTH CAROLINA_GUILFORD,1672939034,30330023,10279.32867,16,1703269057,98.219305,6.541057
NORTH CAROLINA_HALIFAX,1874472932,16919664,13755.90949,20,1891392596,99.105439,6.940038
NORTH CAROLINA_HARNETT,1541100224,16378002,11833.61224,17,1557478226,98.948428,7.034926
NORTH CAROLINA_HAYWOOD,1433713829,2438478,10285.3454,15,1436152307,99.830208,6.868559
NORTH CAROLINA_HENDERSON,965918074,5547623,7535.7677,11,971465697,99.428943,6.890044
NORTH CAROLINA_HERTFORD,914689324,18737419,7721.278809,11,933426743,97.99262,7.163136
NORTH CAROLINA_HOKE,1010416546,3941216,8256.754639,12,1014357762,99.611457,6.907467
NORTH CAROLINA_HYDE,1585966935,2192929400,8581.650146,12,3778896335,41.969051,17.03964
NORTH CAROLINA_IREDELL,1487420594,59920122,9477.118103,15,1547340716,96.127542,6.5726
NORTH CAROLINA_JACKSON,1271961083,9754330,10449.79865,15,1281715413,99.238963,7.019957
NORTH CAROLINA_JOHNSTON,2049252369,11592754,14214.17236,20,2060845123,99.437476,7.147291
NORTH CAROLINA_JONES,1220836962,6031825,8703.987122,12,1226868787,99.508356,7.289159
NORTH CAROLINA_LEE,660607408,10725289,5554.306824,8,671332697,98.402388,7.055605
NORTH CAROLINA_LENOIR,1033630022,5900301,8025.116333,11,1039530323,99.432407,7.337206
NORTH CAROLINA_LINCOLN,766230937,23359099,4314.891235,7,789590036,97.041617,6.352048
NORTH CAROLINA_MACON,1335344512,10604264,8377.086304,12,1345948776,99.212135,7.036342
NORTH CAROLINA_MADISON,1164497715,4840763,9478.120728,14,1169338478,99.586026,6.798229
NORTH CAROLINA_MARTIN,1182135160,746610,7932.862122,11,1182881770,99.936882,7.216248
NORTH CAROLINA_MCDOWELL,1139477323,13977081,8735.072876,13,1153454404,98.788242,6.801707
NORTH CAROLINA_MECKLENBURG,1356068834,58270787,8391.125488,14,1414339621,95.88,6.251211
NORTH CAROLINA_MITCHELL,573036225,1632150,4099.297241,6,574668375,99.715984,6.851622
NORTH CAROLINA_MONTGOMERY,1273075615,25886763,8694.962219,13,1298962378,98.00712,6.824435
NORTH CAROLINA_MOORE,1806973893,20724316,11728.32196,17,1827698209,98.866097,6.978138
NORTH CAROLINA_NASH,1399742823,6174819,9847.137634,14,1405917642,99.560798,7.064698
NORTH CAROLINA_NEW HANOVER,497927594,353813801,2853.864929,4,851741395,58.45995,12.204359
NORTH CAROLINA_NORTHAMPTON,1389988119,35935817,10376.59662,15,1425923936,97.479822,7.096577
NORTH CAROLINA_ONSLOW,1973754758,370685631,14460.85248,20,2344440389,84.188737,8.588353
NORTH CAROLINA_ORANGE,1029672897,8807050,6617.236145,10,1038479947,99.151929,6.673835
NORTH CAROLINA_PAMLICO,871546184,583061138,4298.84729,6,1454607322,59.916252,11.957933
NORTH CAROLINA_PASQUOTANK,587616451,161745167,2843.837219,4,749361618,78.415606,9.066554
NORTH CAROLINA_PENDER,2256645338,162833419,16434.29096,23,2419478757,93.269897,7.660933
NORTH CAROLINA_PERQUIMANS,640169367,211759806,3560.813232,5,851929173,75.143496,9.477369
NORTH CAROLINA_PERSON,1016140154,31220109,6349.498596,10,1047360263,97.019162,6.544582
NORTH CAROLINA_PITT,1689629354,8238588,13906.32391,19,1697867942,99.514769,7.354806
NORTH CAROLINA_POLK,615606314,1964035,3960.915833,6,617570349,99.681974,6.622588
NORTH CAROLINA_RANDOLPH,2026229975,19767036,15838.64948,24,2045997011,99.033868,6.663819
NORTH CAROLINA_RICHMOND,1226849546,15575097,10085.79535,15,1242424643,98.746395,6.809224
NORTH CAROLINA_ROBESON,2453435687,5076395,17621.56287,26,2458512082,99.793518,6.791548
NORTH CAROLINA_ROCKINGHAM,1464997156,18444290,10597.20477,17,1483441446,98.756655,6.312131
NORTH CAROLINA_ROWAN,1324727249,32231668,9930.366943,16,1356958917,97.624713,6.357488
NORTH CAROLINA_RUTHERFORD,1464476077,4692959,10450.80109,16,1469169036,99.680571,6.552682
NORTH CAROLINA_SAMPSON,2449357434,4923826,17085.08441,24,2454281260,99.799378,7.133096
NORTH CAROLINA_SCOTLAND,826570080,3841985,6074.741272,9,830412065,99.53734,6.781086
NORTH CAROLINA_STANLY,1023390690,25222524,7057.449585,11,1048613214,97.594678,6.573989
NORTH CAROLINA_STOKES,1162941527,17582831,6256.241577,10,1180524358,98.510591,6.350831
NORTH CAROLINA_SURRY,1382386028,10337426,10215.15179,16,1392723454,99.257755,6.432213
NORTH CAROLINA_SWAIN,1366810463,32416167,10662.38416,16,1399226630,97.68328,6.822038
NORTH CAROLINA_TRANSYLVANIA,979930393,5103716,6979.233948,10,985034109,99.481874,7.015583
NORTH CAROLINA_TYRRELL,1012103918,534574451,7862.668701,11,1546678369,65.437258,10.923258
NORTH CAROLINA_UNION,1638745719,17924710,11762.41589,19,1656670429,98.918028,6.25846
NORTH CAROLINA_VANCE,653713542,42178610,4554.551636,7,695892152,93.938916,6.926312
NORTH CAROLINA_WAKE,2162195848,58055278,17186.36359,25,2220251126,97.385193,7.059128
NORTH CAROLINA_WARREN,1112117463,38615563,7856.651794,12,1150733026,96.644264,6.774546
NORTH CAROLINA_WASHINGTON,897456203,195282199,5042.897644,7,1092738402,82.129099,8.771726
NORTH CAROLINA_WATAUGA,809217076,2275614,5364.784668,8,811492690,99.719577,6.724839
NORTH CAROLINA_WAYNE,1434643400,9850061,11621.02625,16,1444493461,99.318096,7.313009
NORTH CAROLINA_WILKES,1954249757,6862433,13627.55573,21,1961112190,99.650074,6.5121
NORTH CAROLINA_WILSON,951946703,14398771,7219.897217,10,966345474,98.509977,7.329103
NORTH CAROLINA_YADKIN,867496099,7232594,6308.385254,10,874728693,99.173161,6.36098
NORTH CAROLINA_YANCEY,809610027,1524561,5463.055664,8,811134588,99.812046,6.841679
NORTH DAKOTA_ADAMS,2557733901,2894336,13914.34625,28,2560628237,99.886968,4.975033
NORTH DAKOTA_BARNES,3863118055,56580900,26183.15802,42,3919698955,98.556499,6.325392
NORTH DAKOTA_BENSON,3596341060,131678181,24344.08978,40,3728019241,96.467878,6.308859
NORTH DAKOTA_BILLINGS,2974571254,11986483,16460.36292,32,2986557737,99.598652,5.164591
NORTH DAKOTA_BOTTINEAU,4321075833,74935382,26756.73853,45,4396011215,98.295378,6.049055
NORTH DAKOTA_BOWMAN,3009070659,13583664,15615.03311,32,3022654323,99.550605,4.901726
NORTH DAKOTA_BURKE,2858179013,65714655,17856.21008,31,2923893668,97.752495,5.892502
NORTH DAKOTA_BURLEIGH,4228659152,92691317,26338.58569,44,4321350469,97.855038,6.117255
NORTH DAKOTA_CASS,4571158976,7449683,29517.34644,49,4578608659,99.837294,6.033766
NORTH DAKOTA_CAVALIER,3856631212,54090823,25353.87268,40,3910722035,98.616858,6.427368
NORTH DAKOTA_DICKEY,2930554406,27619632,18857.97064,30,2958174038,99.066328,6.345234
NORTH DAKOTA_DIVIDE,3265658855,86686807,18735.63312,34,3352345662,97.414145,5.656756
NORTH DAKOTA_DUNN,5201969429,190528746,31904.92523,57,5392498175,96.466781,5.802366
NORTH DAKOTA_EDDY,1632310788,36012934,11134.68549,18,1668323722,97.84137,6.322414
NORTH DAKOTA_EMMONS,3910888908,117348492,24004.15204,41,4028237400,97.086853,6.030344
NORTH DAKOTA_FOSTER,1642258774,33103934,11185.82697,18,1675362708,98.024074,6.339614
NORTH DAKOTA_GOLDEN VALLEY,2592280439,4148883,13252.52222,26,2596429322,99.840208,5.105282
NORTH DAKOTA_GRAND FORKS,3719806629,8267350,23389.45886,37,3728073979,99.778241,6.335525
NORTH DAKOTA_GRANT,4297393836,17563450,21768.99277,41,4314957286,99.592964,5.33121
NORTH DAKOTA_GRIGGS,1835407690,20525248,12748.13269,20,1855932938,98.894074,6.445347
NORTH DAKOTA_HETTINGER,2932485809,4008872,15979.03607,31,2936494681,99.863481,5.161574
NORTH DAKOTA_KIDDER,3499233948,211737414,24234.78809,40,3710971362,94.294286,6.425307
NORTH DAKOTA_LA MOURE,2968139583,12824671,19546.86945,31,2980964254,99.569781,6.332686
NORTH DAKOTA_LOGAN,2570819041,47710154,17011.88226,28,2618529195,98.177979,6.188427
NORTH DAKOTA_MCHENRY,4853487956,97323497,31042.54889,53,4950811453,98.034191,5.974533
NORTH DAKOTA_MCINTOSH,2524106808,51795568,16289.89246,27,2575902376,97.989226,6.157099
NORTH DAKOTA_MCKENZIE,7148712746,260119355,39515.90118,74,7408832101,96.489064,5.534292
NORTH DAKOTA_MCLEAN,5465546322,563843611,35332.37128,61,6029389933,90.648414,6.389733
NORTH DAKOTA_MERCER,2700790004,180823533,15175.82245,27,2881613537,93.724921,5.996991
NORTH DAKOTA_MORTON,4988026151,49931487,31929.99469,57,5037957638,99.008894,5.657829
NORTH DAKOTA_MOUNTRAIL,4727397872,301102221,31786.60089,55,5028500093,94.012087,6.147488
NORTH DAKOTA_NELSON,2542889235,70073746,17904.34253,28,2612962981,97.318227,6.570617
NORTH DAKOTA_OLIVER,1871017444,22475760,12000.0708,21,1893493204,98.813,5.782963
NORTH DAKOTA_PEMBINA,2897362282,7010380,19595.00171,31,2904372662,99.758627,6.336262
NORTH DAKOTA_PIERCE,2637345167,166227817,15903.82867,26,2803572984,94.070858,6.502393
NORTH DAKOTA_RAMSEY,3070120687,299469855,21236.52564,34,3369590542,91.112574,6.855296
NORTH DAKOTA_RANSOM,2233792873,3582338,14409.71137,24,2237375211,99.839887,6.013675
NORTH DAKOTA_RENVILLE,2272103544,40658499,14111.89093,24,2312762043,98.241994,5.985174
NORTH DAKOTA_RICHLAND,3718378999,25035244,25386.96283,43,3743414243,99.331219,5.943695
NORTH DAKOTA_ROLETTE,2338477672,94404707,18083.83722,29,2432882379,96.119635,6.487546
NORTH DAKOTA_SARGENT,2223461624,21731922,14573.16217,24,2245193546,99.032069,6.1315
NORTH DAKOTA_SHERIDAN,2518053323,86198840,16582.7002,28,2604252163,96.690073,6.12513
NORTH DAKOTA_SIOUX,2833580511,88449896,15974.02258,30,2922030407,96.972999,5.490883
NORTH DAKOTA_SLOPE,3147520228,10980609,16302.92896,33,3158500837,99.652347,4.957516
NORTH DAKOTA_STARK,3457408930,14023939,18502.99207,35,3471432869,99.596019,5.308013
NORTH DAKOTA_STEELE,1844441513,8435674,12590.69873,20,1852877187,99.544726,6.324142
NORTH DAKOTA_STUTSMAN,5754703479,197271625,37889.4195,61,5951975104,96.685611,6.424307
NORTH DAKOTA_TOWNER,2654501912,42795048,18108.90613,29,2697296960,98.41341,6.345121
NORTH DAKOTA_TRAILL,2232235429,1462184,14974.26758,24,2233697613,99.93454,6.243365
NORTH DAKOTA_WALSH,3319346396,32181391,23429.56928,37,3351527787,99.039799,6.393708
NORTH DAKOTA_WARD,5213464365,111251907,32748.25012,57,5324716272,97.910651,5.867908
NORTH DAKOTA_WELLS,3290664846,51166900,20344.06628,34,3341831746,98.468897,6.076588
NORTH DAKOTA_WILLIAMS,5380949615,181846407,33368.96051,61,5562796022,96.731025,5.655188
OHIO_ADAMS,1512208932,6165938,8851.393494,14,1518374870,99.593912,6.348203
OHIO_ALLEN,1042479889,11259523,6271.282959,10,1053739412,98.93147,6.339017
OHIO_ASHLAND,1095464861,9966295,8295.86261,13,1105431156,99.098425,6.43949
OHIO_ASHTABULA,1818360017,1724498211,12521.50769,19,3542858228,51.324662,12.840352
OHIO_ATHENS,1304386904,12461326,8948.661377,14,1316848230,99.053701,6.452965
OHIO_AUGLAIZE,1039590266,1339586,6335.459961,10,1040929852,99.871309,6.343624
OHIO_BELMONT,1378199039,23695983,7844.618835,12,1401895022,98.309718,6.649579
OHIO_BROWN,1269138600,8895015,10388.62988,16,1278033615,99.304008,6.5384
OHIO_BUTLER,1208303733,9058528,8814.291138,13,1217362261,99.255889,6.831055
OHIO_CARROLL,1022031301,11192656,7274.046143,11,1033223957,98.916725,6.685188
OHIO_CHAMPAIGN,1111090195,2173112,7708.242981,12,1113263307,99.804798,6.436099
OHIO_CLARK,1027907572,14611224,5179.273438,8,1042518796,98.598469,6.566118
OHIO_CLERMONT,1170983309,19806060,7253.991211,11,1190789369,98.336729,6.706078
OHIO_CLINTON,1058489018,9349888,8666.884949,13,1067838906,99.12441,6.725724
OHIO_COLUMBIANA,1377658481,7277032,10622.2738,16,1384935513,99.474558,6.673989
OHIO_COSHOCTON,1460647672,9126264,9642.573669,15,1469773936,99.37907,6.468548
OHIO_CRAWFORD,1040619651,2359514,6969.206421,11,1042979165,99.773772,6.350008
OHIO_CUYAHOGA,1184093716,2041810673,8272.799011,13,3225904389,36.705791,17.337023
OHIO_DARKE,1549072768,4244900,11079.53375,17,1553317668,99.72672,6.535232
OHIO_DEFIANCE,1065649892,7073996,6972.214661,11,1072723888,99.340558,6.380452
OHIO_DELAWARE,1147778026,36698376,10082.78723,16,1184476402,96.901722,6.50323
OHIO_ERIE,651069515,969942442,3138.649719,5,1621011957,40.164387,15.63526
OHIO_FAIRFIELD,1306415001,10754493,8688.94574,14,1317169494,99.183515,6.257481
OHIO_FAYETTE,1052469899,1694038,6423.702881,10,1054163937,99.8393,6.434042
OHIO_FRANKLIN,1378938272,29041546,8730.059021,14,1407979818,97.937361,6.367086
OHIO_FULTON,1050103171,4586248,6871.938477,11,1054689419,99.565157,6.274501
OHIO_GALLIA,1208308871,12084300,8218.64978,13,1220393171,99.009803,6.385265
OHIO_GEAUGA,1036773424,20701751,7113.604309,11,1057475175,98.042342,6.596041
OHIO_GREENE,1071283002,6815334,7916.817688,12,1078098336,99.367837,6.639319
OHIO_GUERNSEY,1352631181,15666081,8343.994995,13,1368297262,98.855067,6.492796
OHIO_HAMILTON,1049999711,18744132,7382.344788,11,1068743843,98.246153,6.831028
OHIO_HANCOCK,1376125660,6020647,8084.279236,13,1382146307,99.564399,6.245883
OHIO_HARDIN,1218096651,629922,8177.536438,13,1218726573,99.948313,6.293666
OHIO_HARRISON,1042032640,21847163,7920.828796,12,1063879803,97.946463,6.73908
OHIO_HENRY,1077461471,9687647,6810.769531,11,1087149118,99.108894,6.247279
OHIO_HIGHLAND,1432479990,12194983,9714.772766,15,1444674973,99.155867,6.531651
OHIO_HOCKING,1091235303,5955974,6870.935669,11,1097191277,99.457162,6.280398
OHIO_HOLMES,1094405864,3695230,7741.333862,12,1098101094,99.663489,6.472894
OHIO_HURON,1272964850,8616411,8220.655334,13,1281581261,99.327673,6.366384
OHIO_JACKSON,1088598927,3167846,6922.076477,11,1091766773,99.709842,6.311109
OHIO_JEFFERSON,1057037023,7335056,7349.253723,11,1064372079,99.310856,6.727502
OHIO_KNOX,1361052758,10720132,10192.08844,16,1371772890,99.21852,6.420228
OHIO_LAKE,593807218,1942301625,3869.664246,6,2536108843,23.414106,27.545106
OHIO_LAWRENCE,1174224668,10110059,6935.112366,11,1184334727,99.146351,6.358931
OHIO_LICKING,1767507224,12750817,10026.63232,16,1780258041,99.283766,6.311853
OHIO_LOGAN,1187534495,21593254,7612.980774,12,1209127749,98.214146,6.459508
OHIO_LORAIN,1272195542,1119495034,8189.569641,13,2391690576,53.192313,11.843194
OHIO_LUCAS,879702815,663509628,4950.643433,8,1543212443,57.004648,10.855789
OHIO_MADISON,1206445849,2119319,9534.275513,15,1208565168,99.824642,6.367349
OHIO_MAHONING,1065773136,35456512,7267.026978,11,1101229648,96.78028,6.826172
OHIO_MARION,1045858048,908577,7587.91156,12,1046766625,99.913202,6.328753
OHIO_MEDINA,1091568894,4198457,7633.036011,12,1095767351,99.616848,6.385329
OHIO_MEIGS,1113957867,7519818,8363.047485,13,1121477685,99.329472,6.47654
OHIO_MERCER,1197723422,28440771,7698.215271,12,1226164193,97.680509,6.567512
OHIO_MIAMI,1052862600,7944952,8451.29071,13,1060807552,99.251047,6.55005
OHIO_MONROE,1180317741,4495411,9741.84729,15,1184813152,99.620581,6.5193
OHIO_MONTGOMERY,1195326276,7511399,7965.953308,12,1202837675,99.375527,6.680009
OHIO_MORGAN,1078538278,13868572,7625.013733,12,1092406850,98.730457,6.435884
OHIO_MORROW,1051881046,2819351,6360.528931,10,1054700397,99.732687,6.377577
OHIO_MUSKINGUM,1721165860,20823924,10756.64429,17,1741989784,98.80459,6.403992
OHIO_NOBLE,1030846459,16984489,7634.038635,12,1047830948,98.379081,6.466516
OHIO_OTTAWA,659705457,855637066,3117.591797,5,1515342523,43.535072,14.322208
OHIO_PAULDING,1078561236,6245396,7608.969604,12,1084806632,99.424285,6.377524
OHIO_PERRY,1056544098,11790392,6874.946594,11,1068334490,98.896376,6.319697
OHIO_PICKAWAY,1298175198,13790233,9954.433167,16,1311965431,98.948887,6.287611
OHIO_PIKE,1140324465,9567611,6918.065552,11,1149892076,99.167956,6.341918
OHIO_PORTAGE,1262370046,43127727,9110.106201,14,1305497773,96.696453,6.729532
OHIO_PREBLE,1098741224,6062615,7324.184631,11,1104803839,99.45125,6.695089
OHIO_PUTNAM,1249783588,4544874,9336.731018,15,1254328462,99.637665,6.247123
OHIO_RICHLAND,1282554028,12637716,8310.904236,13,1295191744,99.024259,6.455997
OHIO_ROSS,1784986619,9938848,11310.16974,18,1794925467,99.446281,6.318414
OHIO_SANDUSKY,1057350969,24514231,6859.905029,11,1081865200,97.734077,6.380863
OHIO_SCIOTO,1580488534,15326840,11300.14209,18,1595815374,99.039561,6.338736
OHIO_SENECA,1427151734,4576816,10018.61017,16,1431728550,99.680329,6.281712
OHIO_SHELBY,1055927003,7802978,7014.330566,11,1063729981,99.266451,6.423786
OHIO_STARK,1490056765,13646455,11735.34113,18,1503703220,99.092477,6.579343
OHIO_SUMMIT,1069119180,19017971,7723.284302,12,1088137151,98.252245,6.550558
OHIO_TRUMBULL,1600837668,47866857,11199.86542,17,1648704525,97.096699,6.785149
OHIO_TUSCARAWAS,1469641510,10408848,11084.54761,17,1480050358,99.296723,6.566503
OHIO_UNION,1118161949,13254689,5697.702332,9,1131416638,98.828487,6.405825
OHIO_VAN WERT,1059702138,3278633,7644.066101,12,1062980771,99.691562,6.389764
OHIO_VINTON,1067997064,6792846,6909.040527,11,1074789910,99.367984,6.320895
OHIO_WARREN,1039075224,15830492,8131.409241,12,1054905716,98.499345,6.879411
OHIO_WASHINGTON,1636805233,20784946,9663.631714,15,1657590179,98.746074,6.52423
OHIO_WAYNE,1436939444,5040384,8987.769104,14,1441979828,99.650454,6.442354
OHIO_WILLIAMS,1089503873,6299797,7671.140747,12,1095803670,99.425098,6.429581
OHIO_WOOD,1598510313,8650452,10515.98071,17,1607160765,99.461756,6.219346
OHIO_WYANDOT,1053812243,1783532,7512.704224,12,1055595775,99.83104,6.271183
OKLAHOMA_ADAIR,1486277939,8874158,10560.1023,18,1495152097,99.406471,5.901752
OKLAHOMA_ALFALFA,2244392665,38546676,10408.685,23,2282939341,98.311533,4.603239
OKLAHOMA_ATOKA,2526393964,37287777,17026.92444,27,2563681741,98.545538,6.399344
OKLAHOMA_BEAVER,4700407527,7347161,25572.4747,51,4707754688,99.843935,5.022048
OKLAHOMA_BECKHAM,2335338428,5514684,11931.88278,22,2340853112,99.764416,5.43639
OKLAHOMA_BLAINE,2404772608,26854992,12215.6648,25,2431627600,98.895596,4.940833
OKLAHOMA_BRYAN,2341975631,102083435,17052.99634,27,2444059066,95.823201,6.591227
OKLAHOMA_CADDO,3309366436,32099077,19776.50134,36,3341465513,99.039371,5.546756
OKLAHOMA_CANADIAN,2322131002,23131671,13045.95325,24,2345262673,99.013685,5.489962
OKLAHOMA_CARTER,2129492350,29991371,13726.82959,24,2159483721,98.611179,5.800065
OKLAHOMA_CHEROKEE,1939904010,69990998,12629.80597,21,2009895008,96.517679,6.231183
OKLAHOMA_CHOCTAW,1995090099,75667486,12616.77045,20,2070757585,96.345903,6.547642
OKLAHOMA_CIMARRON,4752131813,15923999,18226.22934,49,4768055812,99.666027,3.732103
OKLAHOMA_CLEVELAND,1395453713,49520727,9013.841309,16,1444974440,96.572899,5.833573
OKLAHOMA_COAL,1338427185,12083335,9349.767029,15,1350510520,99.105276,6.289451
OKLAHOMA_COMANCHE,2769653950,37538945,14405.70004,28,2807192895,98.662759,5.214625
OKLAHOMA_COTTON,1638512879,23996512,8813.28833,17,1662509391,98.556609,5.260213
OKLAHOMA_CRAIG,1971621943,3684477,12418.22278,22,1975306420,99.813473,5.655195
OKLAHOMA_CREEK,2460107102,50925023,14389.65631,26,2511032125,97.971949,5.641648
OKLAHOMA_CUSTER,2560925953,34326632,13874.23566,28,2595252585,98.67733,5.021502
OKLAHOMA_DELAWARE,1911485747,140309019,12186.58527,21,2051794766,93.161645,6.229104
OKLAHOMA_DEWEY,2589042126,22668868,13422.99204,29,2611710994,99.13203,4.669145
OKLAHOMA_ELLIS,3189510402,952235,12896.54132,30,3190462637,99.970154,4.300131
OKLAHOMA_GARFIELD,2741521308,4075930,14677.44928,30,2745597238,99.851547,4.899757
OKLAHOMA_GARVIN,2077453378,30109357,11541.80811,21,2107562735,98.571366,5.575756
OKLAHOMA_GRADY,2850386644,11374380,17274.60657,32,2861761024,99.602539,5.419856
OKLAHOMA_GRANT,2591904428,7042653,14959.22589,30,2598947081,99.729019,4.999958
OKLAHOMA_GREER,1655732413,11156357,10828.84369,18,1666888770,99.330708,6.05656
OKLAHOMA_HARMON,1391491968,3800411,8792.230591,15,1395292379,99.727626,5.877496
OKLAHOMA_HARPER,2689919308,5259447,10068.74808,23,2695178755,99.804857,4.386276
OKLAHOMA_HASKELL,1493706599,126248912,11254.01495,18,1619955511,92.206643,6.780673
OKLAHOMA_HUGHES,2083606775,26430453,12797.26794,21,2110037228,98.747394,6.171238
OKLAHOMA_JACKSON,2078860509,4114418,12974.75714,23,2082974927,99.802474,5.652364
OKLAHOMA_JEFFERSON,1965685986,39417590,13995.57037,26,2005103576,98.034137,5.490854
OKLAHOMA_JOHNSTON,1665488649,39648868,10025.62952,16,1705137517,97.674741,6.415188
OKLAHOMA_KAY,2381740395,65583671,14567.14554,27,2447324066,97.320189,5.543803
OKLAHOMA_KINGFISHER,2326005907,20612229,12618.77585,25,2346618136,99.12162,5.09224
OKLAHOMA_KIOWA,2629039881,40296743,14910.09052,28,2669336624,98.490384,5.406652
OKLAHOMA_LATIMER,1870210358,18276407,11352.28571,18,1888486765,99.032219,6.368458
OKLAHOMA_LE FLORE,4115999004,50035433,29864.3031,48,4166034437,98.798967,6.297363
OKLAHOMA_LINCOLN,2466630673,34722233,15418.49048,27,2501352906,98.611862,5.785316
OKLAHOMA_LOGAN,1926542719,12929098,11173.79364,21,1939471817,99.33337,5.356563
OKLAHOMA_LOVE,1331024899,47506501,8814.29126,15,1378531400,96.553833,6.085925
OKLAHOMA_MAJOR,2473438538,7651007,13462.10007,30,2481089545,99.691627,4.501247
OKLAHOMA_MARSHALL,962443215,143430766,6102.818481,10,1105873981,87.030099,7.012308
OKLAHOMA_MAYES,1697419131,72863521,10772.68866,19,1770282652,95.884074,5.91322
OKLAHOMA_MCCLAIN,1478150205,24716284,8736.075623,16,1502866489,98.355391,5.551345
OKLAHOMA_MCCURTAIN,4793716602,133984721,35077.67065,56,4927701323,97.280989,6.438945
OKLAHOMA_MCINTOSH,1601359179,242867678,11098.58649,18,1844226857,86.830922,7.10102
OKLAHOMA_MURRAY,1078402382,22714095,6520.970642,11,1101116477,97.937176,6.053018
OKLAHOMA_MUSKOGEE,2099505908,76119907,14395.67285,23,2175625815,96.501241,6.485915
OKLAHOMA_NOBLE,1895660471,27566422,10879.98358,21,1923226893,98.566658,5.256285
OKLAHOMA_NOWATA,1465460409,38903890,9032.893433,16,1504364299,97.413932,5.795432
OKLAHOMA_OKFUSKEE,1601767639,26681052,8181.547791,14,1628448691,98.361566,5.941307
OKLAHOMA_OKLAHOMA,1835932121,24822783,11240.97888,20,1860754904,98.665983,5.696481
OKLAHOMA_OKMULGEE,1806373387,12958196,9944.404663,17,1819331583,99.28775,5.884121
OKLAHOMA_OSAGE,5818679077,148729736,34060.8667,61,5967408813,97.507633,5.726473
OKLAHOMA_OTTAWA,1219409732,35714886,9342.747925,16,1255124618,97.154475,6.01024
OKLAHOMA_PAWNEE,1472023155,68854232,8144.444885,15,1540877387,95.531492,5.683602
OKLAHOMA_PAYNE,1773885714,31992048,10874.97058,20,1805877762,98.228449,5.529237
OKLAHOMA_PITTSBURG,3381281071,187427366,23190.91144,37,3568708437,94.748034,6.615244
OKLAHOMA_PONTOTOC,1865835819,12595147,8645.826843,14,1878430966,99.329486,6.217278
OKLAHOMA_POTTAWATOMIE,2040370700,14850384,11234.96185,19,2055221084,99.277431,5.956175
OKLAHOMA_PUSHMATAHA,3614424104,69997259,24991.87482,39,3684421363,98.100183,6.532274
OKLAHOMA_ROGER MILLS,2955503143,13688536,15641.10501,33,2969191679,99.538981,4.761681
OKLAHOMA_ROGERS,1749883768,92870077,8318.925781,15,1842753845,94.960256,5.840286
OKLAHOMA_SEMINOLE,1639027599,19925659,12140.45746,20,1658953258,98.798902,6.144025
OKLAHOMA_SEQUOYAH,1744289208,105113803,12818.32599,21,1849403011,94.316339,6.4718
OKLAHOMA_STEPHENS,2253798301,54865799,12408.19507,24,2308664100,97.623483,5.29594
OKLAHOMA_TEXAS,5286873577,19218939,25337.82782,56,5306092516,99.637795,4.54106
OKLAHOMA_TILLMAN,2256226938,20895054,12412.20648,24,2277121992,99.082392,5.219649
OKLAHOMA_TULSA,1476502056,43340940,8848.385071,16,1519842996,97.148328,5.692574
OKLAHOMA_WAGONER,1454748498,75357245,9455.056702,16,1530105743,95.07503,6.215523
OKLAHOMA_WASHINGTON,1076201559,22871164,7850.63562,14,1099072723,97.919049,5.726768
OKLAHOMA_WASHITA,2597989594,14579003,14608.25833,28,2612568597,99.441967,5.246512
OKLAHOMA_WOODS,3331924479,9128597,14946.18982,34,3341053076,99.726775,4.407982
OKLAHOMA_WOODWARD,3218800597,9693573,15769.45853,37,3228494170,99.699749,4.274851
OREGON_BAKER,7945996793,51832631,31950.05048,86,7997829424,99.351916,3.739356
OREGON_BENTON,1748712549,7740248,11465.59747,19,1756452797,99.559325,6.061235
OREGON_CLACKAMAS,4845035564,31872078,25856.25668,51,4876907642,99.34647,5.103205
OREGON_CLATSOP,2144872198,661629272,14458.84717,22,2806501470,76.425123,8.599532
OREGON_COLUMBIA,1704508477,79930091,10632.30158,18,1784438568,95.520715,6.183825
OREGON_COOS,4133803901,544637639,27939.99927,45,4678441540,88.358567,7.026923
OREGON_CROOK,7715390842,21004473,22876.04315,80,7736395315,99.728498,2.867891
OREGON_CURRY,4217488411,934615925,27123.74939,43,5152104336,81.85953,7.705699
OREGON_DESCHUTES,7815590704,94710204,26532.11926,84,7910300908,98.802698,3.196862
OREGON_DOUGLAS,13042325534,251974549,69439.36624,135,13294300083,98.104642,5.243031
OREGON_GILLIAM,3120213942,46914717,9830.090668,32,3167128659,98.518699,3.118092
OREGON_GRANT,11726925903,1893807,38759.81766,122,11728819710,99.983853,3.177547
OREGON_HARNEY,26248072899,241568254,78715.93221,280,26489641153,99.088065,2.837156
OREGON_HOOD RIVER,1352203435,29040409,5498.152161,14,1381243844,97.897518,4.011595
OREGON_JACKSON,7208597903,46766412,31390.50845,76,7255364315,99.355423,4.157126
OREGON_JEFFERSON,4615977076,26212115,16326.99515,50,4642189191,99.43535,3.272866
OREGON_JOSEPHINE,4244080709,5631820,22936.2096,45,4249712529,99.867478,5.103699
OREGON_KLAMATH,15391639810,503686589,58429.02353,166,15895326399,96.831228,3.635006
OREGON_LAKE,21078875998,568514572,73015.22128,227,21647390570,97.37375,3.303282
OREGON_LANE,11800116009,436246925,65497.50308,127,12236362934,96.434832,5.347947
OREGON_LINCOLN,2540784310,553094279,17506.24493,27,3093878589,82.122948,7.888462
OREGON_LINN,5923936549,50054677,32023.25211,63,5973991226,99.162123,5.126005
OREGON_MALHEUR,25609052021,108996486,76335.3719,271,25718048507,99.576187,2.828792
OREGON_MARION,3057633979,26550710,16665.92938,32,3084184689,99.139134,5.221029
OREGON_MORROW,5259046542,44372276,17395.94118,56,5303418818,99.163327,3.132628
OREGON_MULTNOMAH,1116560269,88220750,7479.612823,14,1204781019,92.677445,5.764704
OREGON_POLK,1918983325,8153115,12568.63776,21,1927136440,99.576931,6.010494
OREGON_SHERMAN,2133151636,19617472,7810.524872,24,2152769108,99.088733,3.284314
OREGON_TILLAMOOK,2855122940,595798850,19923.90772,31,3450921790,82.735081,7.768249
OREGON_UMATILLA,8327974446,41621245,27972.08797,88,8369595691,99.502709,3.194532
OREGON_UNION,5275651497,4936782,21459.13892,59,5280588279,99.906511,3.640546
OREGON_WALLOWA,8147835329,14191752,36351.17966,83,8162027081,99.826125,4.387289
OREGON_WASCO,6167112266,35724414,21504.26297,64,6202836680,99.424063,3.379505
OREGON_WASHINGTON,1875859540,6114246,9056.959839,16,1881973786,99.675115,5.67905
OREGON_WHEELER,4444475023,1241033,14159.02036,47,4445716056,99.972085,3.013399
OREGON_YAMHILL,1854169185,6491759,11095.57788,19,1860660944,99.651105,5.860224
PENNSYLVANIA_ADAMS,1343396085,7776214,9001.807678,14,1351172299,99.424484,6.467082
PENNSYLVANIA_ALLEGHENY,1890994512,37306408,13883.2608,21,1928300920,98.065322,6.741503
PENNSYLVANIA_ARMSTRONG,1691756729,27587112,11872.71918,18,1719343841,98.395486,6.703514
PENNSYLVANIA_BEAVER,1125901370,24162727,7329.198425,11,1150064097,97.89901,6.805899
PENNSYLVANIA_BEDFORD,2621851579,11920892,18584.21582,28,2633772471,99.547383,6.667398
PENNSYLVANIA_BERKS,2218082423,24209929,14686.47455,23,2242292352,98.920305,6.455119
PENNSYLVANIA_BLAIR,1361819111,3281615,9088.045532,14,1365100726,99.759606,6.507104
PENNSYLVANIA_BRADFORD,2971786846,35239552,20863.49738,32,3007026398,98.828093,6.597155
PENNSYLVANIA_BUCKS,1565393345,45204303,10778.70514,17,1610597648,97.193321,6.523509
PENNSYLVANIA_BUTLER,2044946885,15991831,13190.35077,20,2060938716,99.224051,6.646751
PENNSYLVANIA_CAMBRIA,1782850495,13649939,12571.64587,19,1796500434,99.240193,6.667314
PENNSYLVANIA_CAMERON,1026233354,5660231,8385.108032,13,1031893585,99.451471,6.485659
PENNSYLVANIA_CARBON,987432366,15895107,6555.065002,10,1003327473,98.415761,6.660585
PENNSYLVANIA_CENTRE,2871502921,11214105,17957.48883,28,2882717026,99.610988,6.438435
PENNSYLVANIA_CHESTER,1943860643,22547828,13381.87909,21,1966408471,98.85335,6.446239
PENNSYLVANIA_CLARION,1556156290,23332096,11144.71362,17,1579488386,98.522807,6.654006
PENNSYLVANIA_CLEARFIELD,2964714508,23932643,20073.31928,31,2988647151,99.199215,6.527536
PENNSYLVANIA_CLINTON,2299868389,23178644,14963.23669,23,2323047033,99.002231,6.571322
PENNSYLVANIA_COLUMBIA,1250947317,18559653,7816.541382,12,1269506970,98.538042,6.610426
PENNSYLVANIA_CRAWFORD,2621848897,65300098,19133.72992,29,2687148995,97.569912,6.762164
PENNSYLVANIA_CUMBERLAND,1412783419,12513405,10218.16052,16,1425296824,99.122049,6.442916
PENNSYLVANIA_DAUPHIN,1359456340,86211444,9504.192627,15,1445667784,94.036566,6.737941
PENNSYLVANIA_DELAWARE,476078165,17582417,3147.674622,5,493660582,96.438359,6.527848
PENNSYLVANIA_ELK,2142883446,12791206,14284.36578,22,2155674652,99.406626,6.531651
PENNSYLVANIA_ERIE,2069551279,1966249000,13685.71594,21,4035800279,51.279824,12.708717
PENNSYLVANIA_FAYETTE,2047006949,20605089,14084.8161,21,2067612038,99.003435,6.774568
PENNSYLVANIA_FOREST,1106623930,8356609,7166.750671,11,1114980539,99.250515,6.564427
PENNSYLVANIA_FRANKLIN,2000245529,1547615,13462.10022,21,2001793144,99.922689,6.415484
PENNSYLVANIA_FULTON,1133252791,1305486,7169.759033,11,1134558277,99.884934,6.525471
PENNSYLVANIA_GREENE,1491658067,5296792,12174.5517,18,1496954859,99.646162,6.787657
PENNSYLVANIA_HUNTINGDON,2265337398,37851956,16568.66144,26,2303189354,98.356542,6.479042
PENNSYLVANIA_INDIANA,2142730129,18052433,14635.33313,22,2160782562,99.164542,6.708471
PENNSYLVANIA_JEFFERSON,1689799802,11306230,13077.0387,20,1701106032,99.33536,6.582268
PENNSYLVANIA_JUNIATA,1013695972,5502986,5728.788147,9,1019198958,99.460068,6.399875
PENNSYLVANIA_LACKAWANNA,1188213226,15900575,7911.803955,12,1204113801,98.679479,6.681399
PENNSYLVANIA_LANCASTER,2444751463,103278571,17233.49402,27,2548030034,95.946729,6.652416
PENNSYLVANIA_LAWRENCE,925211452,11803921,7286.079468,11,937015373,98.740264,6.708214
PENNSYLVANIA_LEBANON,937089776,1781314,6314.401794,10,938871090,99.810271,6.326405
PENNSYLVANIA_LEHIGH,894308181,7573804,6442.75531,10,901881985,99.160222,6.497318
PENNSYLVANIA_LUZERNE,2305001140,42213062,15781.49182,24,2347214202,98.201568,6.696045
PENNSYLVANIA_LYCOMING,3182485518,39032440,23789.56128,36,3221517958,98.788384,6.68926
PENNSYLVANIA_MCKEAN,2536067959,13048802,17395.94098,27,2549116761,99.488105,6.476092
PENNSYLVANIA_MERCER,1741807476,26010715,11915.83862,18,1767818191,98.528654,6.718767
PENNSYLVANIA_MIFFLIN,1064602268,9507394,8263.774109,13,1074109662,99.114858,6.413518
PENNSYLVANIA_MONROE,1575379455,22872910,11822.58154,18,1598252365,98.56888,6.663463
PENNSYLVANIA_MONTGOMERY,1250877387,10994646,8222.660828,13,1261872033,99.128704,6.380719
PENNSYLVANIA_MONTOUR,337326257,5407948,1960.402649,3,342734205,98.422116,6.639438
PENNSYLVANIA_NORTHAMPTON,957730763,19073242,7137.670532,11,976804005,98.047383,6.618016
PENNSYLVANIA_NORTHUMBERLAND,1186233370,50558156,8402.155273,13,1236791526,95.912152,6.738663
PENNSYLVANIA_PERRY,1428244411,10591167,9550.319946,15,1438835578,99.263907,6.414094
PENNSYLVANIA_PHILADELPHIA,347781835,21806065,2498.886719,4,369587900,94.099897,6.63892
PENNSYLVANIA_PIKE,1411441244,56692241,10462.83441,16,1468133485,96.138482,6.801929
PENNSYLVANIA_POTTER,2800612694,559778,18670.45349,29,2801172472,99.980016,6.439374
PENNSYLVANIA_SCHUYLKILL,2016645873,10834898,14095.84674,22,2027480771,99.465598,6.441627
PENNSYLVANIA_SNYDER,851544549,7157945,6457.796875,10,858702494,99.166423,6.51208
PENNSYLVANIA_SOMERSET,2782573989,17026008,20215.7124,30,2799599997,99.391841,6.779803
PENNSYLVANIA_SULLIVAN,1165338429,6617028,7913.809204,12,1171955457,99.435386,6.632288
PENNSYLVANIA_SUSQUEHANNA,2132844489,22391441,15010.36664,23,2155235930,98.961068,6.594761
PENNSYLVANIA_TIOGA,2936458661,8267710,19563.91559,30,2944726371,99.719237,6.539666
PENNSYLVANIA_UNION,818323461,4639336,5883.21344,9,822962797,99.436264,6.573964
PENNSYLVANIA_VENANGO,1746388602,22149577,13140.21283,20,1768538179,98.747577,6.653436
PENNSYLVANIA_WARREN,2289908286,37358227,16231.73248,25,2327266513,98.394759,6.598617
PENNSYLVANIA_WASHINGTON,2219586746,10151590,14128.93774,21,2229738336,99.544718,6.758837
PENNSYLVANIA_WAYNE,1879296554,64785158,13810.05884,21,1944081712,96.66757,6.802921
PENNSYLVANIA_WESTMORELAND,2662612862,20837789,19262.08435,29,2683450651,99.22347,6.69408
PENNSYLVANIA_WYOMING,1029021857,20028556,7886.734741,12,1049050413,98.090792,6.7002
PENNSYLVANIA_YORK,2342299893,16499345,15418.49127,24,2358799238,99.300519,6.469625
RHODE ISLAND_BRISTOL,62502352,53357582,352.07349,0.553828,115859934,53.946476,11.80192
RHODE ISLAND_KENT,436581658,50693232,2539.999939,4,487274890,89.596584,7.087324
RHODE ISLAND_NEWPORT,265311877,546983644,1261.47644,2,812295521,32.661989,19.311078
RHODE ISLAND_PROVIDENCE,1060563703,67858968,7662.116089,12,1128422671,93.986387,6.795337
RHODE ISLAND_WASHINGTON,852827550,604769784,5071.977844,8,1457597334,58.509132,10.835868
SOUTH CAROLINA_ABBEVILLE,1272789833,53234749,7969.964233,12,1326024582,95.985387,6.919425
SOUTH CAROLINA_AIKEN,2773048987,24575771,19078.57831,31,2797624758,99.121549,6.208161
SOUTH CAROLINA_ALLENDALE,1056949844,11205142,6014.5755,10,1068154986,98.950982,6.078338
SOUTH CAROLINA_ANDERSON,1848871032,108506374,14043.70282,21,1957377406,94.456543,7.079952
SOUTH CAROLINA_BAMBERG,1018815104,5686290,6136.912598,10,1024501394,99.44497,6.173915
SOUTH CAROLINA_BARNWELL,1420294945,23008122,9075.009583,15,1443303067,98.40587,6.148014
SOUTH CAROLINA_BEAUFORT,1492221617,899581171,2988.235596,5,2391802788,62.388991,9.579368
SOUTH CAROLINA_BERKELEY,2858491238,337284146,17603.51355,28,3195775384,89.445937,7.028792
SOUTH CAROLINA_CALHOUN,987179026,29351080,6190.059082,10,1016530106,97.112621,6.374104
SOUTH CAROLINA_CHARLESTON,2377463289,1139673317,9433.999084,15,3517136606,67.596558,9.30422
SOUTH CAROLINA_CHEROKEE,1018735996,11711031,7970.967163,13,1030447027,98.8635,6.201999
SOUTH CAROLINA_CHESTER,1503905793,14249301,10971.23523,18,1518155094,99.061407,6.152881
SOUTH CAROLINA_CHESTERFIELD,2069363225,17266025,14548.09302,23,2086629250,99.17254,6.378034
SOUTH CAROLINA_CLARENDON,1572019537,229734667,10634.30695,17,1801754204,87.249389,7.169649
SOUTH CAROLINA_COLLETON,2736271582,198925119,16124.43701,26,2935196701,93.222767,6.652566
SOUTH CAROLINA_DARLINGTON,1451949379,14636037,9439.012817,15,1466585416,99.002033,6.356107
SOUTH CAROLINA_DILLON,1049118937,4540145,7225.913696,11,1053659082,99.569107,6.59744
SOUTH CAROLINA_DORCHESTER,1472651489,6707342,10707.50842,17,1479358831,99.546605,6.327222
SOUTH CAROLINA_EDGEFIELD,1296926762,16318325,9574.385864,15,1313245087,98.757404,6.463236
SOUTH CAROLINA_FAIRFIELD,1777521231,61063162,11137.69403,18,1838584393,96.678795,6.400171
SOUTH CAROLINA_FLORENCE,2073312305,9754149,14656.39136,23,2083066454,99.531741,6.402324
SOUTH CAROLINA_GEORGETOWN,2107975277,573070698,13539.31305,21,2681045975,78.625107,8.200042
SOUTH CAROLINA_GREENVILLE,2033481265,25146917,14781.73663,22,2058628182,98.778462,6.802061
SOUTH CAROLINA_GREENWOOD,1177727678,21231559,9131.164246,14,1198959237,98.229168,6.639841
SOUTH CAROLINA_HAMPTON,1450327705,7072565,10341.49994,17,1457400270,99.514714,6.1129
SOUTH CAROLINA_HORRY,2934453641,314430026,20223.73401,30,3248883667,90.321906,7.463577
SOUTH CAROLINA_JASPER,1696861246,120225043,10225.17938,17,1817086289,93.383636,6.440969
SOUTH CAROLINA_KERSHAW,1881915806,35349441,12934.64679,21,1917265247,98.156257,6.275051
SOUTH CAROLINA_LANCASTER,1422080330,15488768,9175.286011,15,1437569098,98.922572,6.18348
SOUTH CAROLINA_LAURENS,1848641840,26091422,14255.28583,22,1874733262,98.60826,6.571128
SOUTH CAROLINA_LEE,1062372374,2715077,6810.769714,11,1065087451,99.745084,6.207433
SOUTH CAROLINA_LEXINGTON,1810381403,151892338,13134.19635,21,1962273741,92.259371,6.779126
SOUTH CAROLINA_MARION,1267172614,12712773,8470.343018,13,1279885387,99.006726,6.581016
SOUTH CAROLINA_MARLBORO,1242867241,14489019,7187.808716,11,1257356260,98.84766,6.610548
SOUTH CAROLINA_MCCORMICK,930140100,89979830,5923.323853,9,1020119930,91.179485,7.218149
SOUTH CAROLINA_NEWBERRY,1631805739,44657734,10724.5556,17,1676463473,97.336194,6.481209
SOUTH CAROLINA_OCONEE,1622673901,122222250,14387.65082,21,1744896151,92.995443,7.36731
SOUTH CAROLINA_ORANGEBURG,2865422661,55784298,19870.76111,32,2921206959,98.090368,6.331904
SOUTH CAROLINA_PICKENS,1287165247,40505290,8242.716003,12,1327670537,96.949146,7.085086
SOUTH CAROLINA_RICHLAND,1961464846,37842441,12386.13483,20,1999307287,98.107222,6.31255
SOUTH CAROLINA_SALUDA,1173136866,23197889,6995.27832,11,1196334755,98.06092,6.485095
SOUTH CAROLINA_SPARTANBURG,2092048331,29186811,13522.26569,21,2121235142,98.624065,6.529009
SOUTH CAROLINA_SUMTER,1722533207,44058465,11125.66101,18,1766591672,97.506019,6.339017
SOUTH CAROLINA_UNION,1331696510,4805060,7471.591003,12,1336501570,99.640475,6.248792
SOUTH CAROLINA_WILLIAMSBURG,2419477548,7461492,16458.35767,26,2426939040,99.692555,6.349659
SOUTH CAROLINA_YORK,1762934643,39245842,10732.57776,18,1802180485,97.822313,6.095279
SOUTH DAKOTA_AURORA,1834902865,11201379,10914.07794,20,1846104244,99.393242,5.490352
SOUTH DAKOTA_BEADLE,3260040834,15805388,19230.99817,35,3275846222,99.517517,5.52121
SOUTH DAKOTA_BENNETT,3068207886,15044356,14420.74173,31,3083252242,99.512062,4.674662
SOUTH DAKOTA_BON HOMME,1459586264,46799495,9893.265137,17,1506385759,96.89326,6.006164
SOUTH DAKOTA_BROOKINGS,2051856894,32918643,15523.78192,24,2084775537,98.420998,6.572015
SOUTH DAKOTA_BROWN,4436728163,46414613,27393.49316,44,4483142776,98.964686,6.290925
SOUTH DAKOTA_BRULE,2116643978,75721265,11000.31558,21,2192365243,96.546138,5.42564
SOUTH DAKOTA_BUFFALO,1220933807,42362357,6839.849731,13,1263296164,96.64668,5.443977
SOUTH DAKOTA_BUTTE,5827518214,42730886,30494.03784,64,5870249100,99.272077,4.799631
SOUTH DAKOTA_CAMPBELL,1900214169,96243697,12805.28998,23,1996457866,95.179277,5.849506
SOUTH DAKOTA_CHARLES MIX,2842481185,136616766,19372.38751,35,2979097951,95.414157,5.800992
SOUTH DAKOTA_CLARK,2480181884,25627353,16334.01404,27,2505809237,98.977282,6.112145
SOUTH DAKOTA_CLAY,1067154439,13955927,8779.19458,14,1081110366,98.709112,6.353141
SOUTH DAKOTA_CODINGTON,1780837047,76608859,12548.58252,20,1857445906,95.875581,6.544202
SOUTH DAKOTA_CORSON,6396478457,155287098,34539.18552,70,6551765555,97.629843,5.053956
SOUTH DAKOTA_CUSTER,4032473656,5481083,19005.37659,42,4037954739,99.864261,4.53124
SOUTH DAKOTA_DAVISON,1128284964,3404556,6789.71167,12,1131689520,99.699162,5.675166
SOUTH DAKOTA_DAY,2663788603,162128327,18560.14948,30,2825916930,94.262806,6.563264
SOUTH DAKOTA_DEUEL,1612885709,35935421,12903.56067,20,1648821130,97.820539,6.595527
SOUTH DAKOTA_DEWEY,5963417247,369819604,32128.54202,66,6333236851,94.160654,5.169846
SOUTH DAKOTA_DOUGLAS,1118358762,4832944,7848.629333,14,1123191706,99.569713,5.630391
SOUTH DAKOTA_EDMUNDS,2916276415,64969684,17591.47876,30,2981246099,97.820721,5.994462
SOUTH DAKOTA_FALL RIVER,4506292097,24021148,20485.45563,48,4530313245,99.469768,4.290553
SOUTH DAKOTA_FAULK,2542569585,62678930,15699.2652,28,2605248515,97.594129,5.7451
SOUTH DAKOTA_GRANT,1764937242,15765681,13763.93213,22,1780702923,99.114637,6.312219
SOUTH DAKOTA_GREGORY,2628707453,99900775,15019.39166,28,2728608228,96.338764,5.567923
SOUTH DAKOTA_HAAKON,4689279880,42452623,22924.17639,53,4731732503,99.10281,4.364474
SOUTH DAKOTA_HAMLIN,1313016440,80582145,9442.021362,15,1393598585,94.217693,6.680997
SOUTH DAKOTA_HAND,3720905364,9241424,21357.86023,40,3730146788,99.75225,5.352726
SOUTH DAKOTA_HANSON,1125574352,1991676,7618.996216,13,1127566028,99.823365,5.871137
SOUTH DAKOTA_HARDING,6919333233,16954253,35053.60333,74,6936287486,99.755572,4.74858
SOUTH DAKOTA_HUGHES,1920546202,153323261,10503.94763,20,2073869463,92.606899,5.671255
SOUTH DAKOTA_HUTCHINSON,2105694681,3644221,11187.8316,19,2109338902,99.827234,5.898523
SOUTH DAKOTA_HYDE,2229019817,14541547,12494.43298,23,2243561364,99.351854,5.467801
SOUTH DAKOTA_JACKSON,4827433523,19106096,21492.23007,48,4846539619,99.605779,4.495269
SOUTH DAKOTA_JERAULD,1362677263,16727973,8041.160522,15,1379405236,98.787305,5.426582
SOUTH DAKOTA_JONES,2511438721,3147179,12900.55234,26,2514585900,99.874843,4.967969
SOUTH DAKOTA_KINGSBURY,2155483578,81655106,13998.57855,23,2237138684,96.35002,6.316904
SOUTH DAKOTA_LAKE,1457881926,31781017,9973.485779,16,1489662943,97.866563,6.369314
SOUTH DAKOTA_LAWRENCE,2072127357,667509,11099.58914,22,2072794866,99.967797,5.046893
SOUTH DAKOTA_LINCOLN,1495182122,1179561,7677.157349,12,1496361683,99.921171,6.402678
SOUTH DAKOTA_LYMAN,4253139889,167659049,25146.29987,49,4420798938,96.207494,5.334198
SOUTH DAKOTA_MARSHALL,2170724143,124586482,14738.61762,24,2295310625,94.57213,6.493552
SOUTH DAKOTA_MCCOOK,1487184878,6895716,9729.814514,16,1494080594,99.538464,6.109331
SOUTH DAKOTA_MCPHERSON,2943892840,38569612,18110.91162,30,2982462452,98.706786,6.116064
SOUTH DAKOTA_MEADE,8989677189,30742155,44697.1796,96,9020419344,99.659194,4.671878
SOUTH DAKOTA_MELLETTE,3385957222,9219640,17414.99371,35,3395176862,99.728449,4.989261
SOUTH DAKOTA_MINER,1476734131,4537900,9562.353149,16,1481272031,99.693648,5.994836
SOUTH DAKOTA_MINNEHAHA,2089691755,18198481,15323.22907,24,2107890236,99.136649,6.440281
SOUTH DAKOTA_MOODY,1345196858,3679400,10390.6355,16,1348876258,99.727225,6.51191
SOUTH DAKOTA_OGLALA LAKOTA,5422402161,7126155,26384.71323,59,5429528316,99.868752,4.477862
SOUTH DAKOTA_PENNINGTON,7191788460,19926710,35828.73966,78,7211715170,99.72369,4.606155
SOUTH DAKOTA_PERKINS,7434457143,50539948,35282.23346,75,7484997091,99.324783,4.736278
SOUTH DAKOTA_POTTER,2230336531,97171992,11773.44592,22,2327508523,95.825064,5.584725
SOUTH DAKOTA_ROBERTS,2851702828,89947544,20203.67865,33,2941650372,96.942276,6.315435
SOUTH DAKOTA_SANBORN,1474346388,3115012,7851.638184,14,1477461400,99.789165,5.620162
SOUTH DAKOTA_SPINK,3894077295,16131734,23114.7016,40,3910209029,99.587446,5.802614
SOUTH DAKOTA_STANLEY,3741060733,188383657,19545.86581,41,3929444390,95.205845,5.007344
SOUTH DAKOTA_SULLY,2607399720,164386962,13937.40976,27,2771786682,94.069278,5.487449
SOUTH DAKOTA_TODD,3596445667,5854544,17079.06778,34,3602300211,99.837478,5.031432
SOUTH DAKOTA_TRIPP,4176247415,13272783,23508.78738,46,4189520198,99.683191,5.126848
SOUTH DAKOTA_TURNER,1598188442,1636386,8683.931946,14,1599824828,99.897715,6.20916
SOUTH DAKOTA_UNION,1193354526,16502840,7062.463135,11,1209857366,98.635968,6.509209
SOUTH DAKOTA_WALWORTH,1835374267,93215243,11437.52005,21,1928589510,95.166662,5.723053
SOUTH DAKOTA_YANKTON,1349873585,28676615,10331.47235,17,1378550200,97.919799,6.206443
SOUTH DAKOTA_ZIEBACH,5079588972,24212302,22944.23132,51,5103801274,99.525603,4.520313
TENNESSEE_ANDERSON,873352567,19665032,5735.807251,9,893017599,97.797912,6.516621
TENNESSEE_BEDFORD,1226719779,2980755,8749.111755,14,1229700534,99.757603,6.264551
TENNESSEE_BENTON,1021248370,108583505,7518.720764,12,1129831875,90.38941,6.931786
TENNESSEE_BLEDSOE,1052644812,829344,7145.692627,11,1053474156,99.921275,6.501202
TENNESSEE_BLOUNT,1447336318,20159163,9544.30304,15,1467495481,98.626288,6.451494
TENNESSEE_BRADLEY,851489145,6959141,5959.423279,9,858448286,99.189335,6.675699
TENNESSEE_CAMPBELL,1243685300,46425148,9049.940369,14,1290110448,96.401459,6.705545
TENNESSEE_CANNON,687992430,156144,4996.770508,8,688148574,99.97731,6.247381
TENNESSEE_CARROLL,1547925981,6308712,11184.82385,18,1554234693,99.594095,6.239116
TENNESSEE_CARTER,883854966,16670131,6119.865723,9,900525097,98.148843,6.928101
TENNESSEE_CHEATHAM,783535609,11821692,5913.297119,10,795357301,98.513663,6.002515
TENNESSEE_CHESTER,740053453,575590,5047.911499,8,740629043,99.922284,6.314797
TENNESSEE_CLAIBORNE,1125609180,18062632,7806.51355,12,1143671812,98.420646,6.60982
TENNESSEE_CLAY,612626856,59070611,4405.140198,7,671697467,91.205771,6.899846
TENNESSEE_COCKE,1129584564,17932684,6510.943298,10,1147517248,98.437262,6.614308
TENNESSEE_COFFEE,1111010383,14479480,9504.192505,15,1125489863,98.713495,6.418705
TENNESSEE_CROCKETT,687714853,545783,4948.637939,8,688260636,99.920701,6.190707
TENNESSEE_CUMBERLAND,1764645664,9027907,11596.95929,18,1773673571,99.491005,6.475716
TENNESSEE_DAVIDSON,1303934398,56688607,7730.303955,13,1360623005,95.833629,6.204907
TENNESSEE_DE KALB,864739794,28502982,6272.285706,10,893242776,96.809044,6.49353
TENNESSEE_DECATUR,788430955,63639368,6286.324524,10,852070323,92.531207,6.778563
TENNESSEE_DICKSON,1268830627,3682667,7803.506042,13,1272513294,99.710599,6.020119
TENNESSEE_DYER,1326983955,36731277,9207.374817,15,1363715232,97.306529,6.308158
TENNESSEE_FAYETTE,1825359642,3774635,10179.05249,16,1829134277,99.793638,6.375064
TENNESSEE_FENTRESS,1291416706,809941,8998.799255,14,1292226647,99.937322,6.431745
TENNESSEE_FRANKLIN,1436135352,55052951,10495.92542,16,1491188303,96.308115,6.811423
TENNESSEE_GIBSON,1561102696,2345196,9794.993652,16,1563447892,99.849998,6.131068
TENNESSEE_GILES,1582304830,642572,9501.184265,15,1582947402,99.959407,6.336695
TENNESSEE_GRAINGER,726715762,56600343,5772.909424,9,783316105,92.774265,6.913926
TENNESSEE_GREENE,1611409740,5099752,10538.04163,16,1616509492,99.684521,6.60712
TENNESSEE_GRUNDY,933545817,1755421,5859.147034,9,935301238,99.812315,6.522405
TENNESSEE_HAMBLEN,417477308,37851130,2563.063599,4,455328438,91.687071,6.988618
TENNESSEE_HAMILTON,1404722581,86573147,11827.59534,18,1491295728,94.19477,6.97585
TENNESSEE_HANCOCK,575816109,2988718,3916.794189,6,578804827,99.48364,6.561873
TENNESSEE_HARDEMAN,1729446895,6831666,12350.03534,19,1736278561,99.606534,6.525695
TENNESSEE_HARDIN,1495273054,49117375,9691.709229,15,1544390429,96.819627,6.673378
TENNESSEE_HAWKINS,1261465131,32544793,9790.982666,15,1294009924,97.484966,6.695721
TENNESSEE_HAYWOOD,1380741545,2472509,9357.789124,15,1383214054,99.821249,6.249697
TENNESSEE_HENDERSON,1346816748,15219341,10009.58539,16,1362036089,98.882604,6.326685
TENNESSEE_HENRY,1455320363,81582234,10535.03351,17,1536902597,94.691776,6.544474
TENNESSEE_HICKMAN,1586324709,373710,10383.61585,17,1586698419,99.976447,6.109448
TENNESSEE_HOUSTON,518758194,17303404,3074.472839,5,536061598,96.772124,6.354046
TENNESSEE_HUMPHREYS,1374668729,67184110,9257.512695,15,1441852839,95.340432,6.473303
TENNESSEE_JACKSON,799341509,28223942,5007.800964,8,827565451,96.589521,6.480777
TENNESSEE_JEFFERSON,712435058,101640420,5694.69397,9,814075478,87.51462,7.230149
TENNESSEE_JOHNSON,772956182,11007739,5395.870422,8,783963921,98.595887,6.840892
TENNESSEE_KNOX,1316558817,45571867,9433.999084,15,1362130684,96.654369,6.507034
TENNESSEE_LAKE,429381243,72799687,4272.775269,7,502180930,85.503295,7.138865
TENNESSEE_LAUDERDALE,1222389174,92231153,8560.592224,14,1314620327,92.984198,6.576073
TENNESSEE_LAWRENCE,1598359112,2218403,11509.71948,18,1600577515,99.8614,6.403163
TENNESSEE_LEWIS,730614737,1024940,5570.351501,9,731639677,99.859912,6.197962
TENNESSEE_LINCOLN,1477179212,971039,9678.673218,15,1478150251,99.934307,6.45669
TENNESSEE_LOUDON,593811362,46869993,4460.292175,7,640681355,92.684352,6.874781
TENNESSEE_MACON,795498353,246690,4885.463989,8,795745043,99.968999,6.108724
TENNESSEE_MADISON,1443073936,3757608,8766.158508,14,1446831544,99.740287,6.277846
TENNESSEE_MARION,1290472802,36484703,7955.925598,12,1326957505,97.2505,6.817382
TENNESSEE_MARSHALL,972442320,1801922,6257.244324,10,974244242,99.815044,6.268839
TENNESSEE_MAURY,1588022042,6318294,10447.79291,17,1594340336,99.603705,6.170213
TENNESSEE_MCMINN,1113997270,5340568,8419.202271,13,1119337838,99.522881,6.507357
TENNESSEE_MCNAIRY,1457753398,1994997,11665.14764,18,1459748395,99.863333,6.489507
TENNESSEE_MEIGS,505397665,55976973,3852.617493,6,561374638,90.028589,7.132211
TENNESSEE_MONROE,1646657184,43535001,11718.29413,18,1690192185,97.424257,6.682282
TENNESSEE_MONTGOMERY,1396430597,12079963,9653.604187,16,1408510560,99.142359,6.085696
TENNESSEE_MOORE,334684848,3093435,1913.272644,3,337778283,99.084182,6.436522
TENNESSEE_MORGAN,1352439675,823018,9650.59552,15,1353262693,99.939183,6.437646
TENNESSEE_OBION,1411148390,27448903,8448.282532,14,1438597293,98.091968,6.151867
TENNESSEE_OVERTON,1122721528,3492728,7636.044067,12,1126214256,99.68987,6.383166
TENNESSEE_PERRY,1074228439,20992254,6242.202759,10,1095220693,98.083285,6.364186
TENNESSEE_PICKETT,422113138,29822845,1913.272827,3,451935983,93.401091,6.82816
TENNESSEE_POLK,1125622729,19906886,8069.237915,12,1145529615,98.262211,6.843287
TENNESSEE_PUTNAM,1038860580,3777708,7636.044067,12,1042638288,99.637678,6.38651
TENNESSEE_RHEA,816838004,54448370,4513.438293,7,871286374,93.750807,6.877561
TENNESSEE_ROANE,934357847,88627625,7656.099731,12,1022985472,91.336375,6.98526
TENNESSEE_ROBERTSON,1233648335,457701,7635.041565,13,1234106036,99.962912,5.875288
TENNESSEE_RUTHERFORD,1603892757,12406559,10418.71271,17,1616299316,99.23241,6.176061
TENNESSEE_SCOTT,1378652164,2418741,9054.954407,14,1381070905,99.824865,6.479172
TENNESSEE_SEQUATCHIE,688550851,498315,5236.430908,8,689049166,99.927681,6.550276
TENNESSEE_SEVIER,1534538395,13489379,10203.11877,16,1548027774,99.128609,6.433006
TENNESSEE_SHELBY,1977610549,55611160,14195.12018,23,2033221709,97.264875,6.345344
TENNESSEE_SMITH,814020539,28690306,5554.307007,9,842710845,96.595474,6.388966
TENNESSEE_STEWART,1190814525,86082696,8690.951294,14,1276897221,93.258448,6.656579
TENNESSEE_SULLIVAN,1070743305,42190911,6714.504456,10,1112934216,96.209038,6.979079
TENNESSEE_SUMNER,1371288348,35636509,8900.528931,15,1406924857,97.467064,6.087888
TENNESSEE_TIPTON,1187273255,38603140,8538.531189,14,1225876395,96.850976,6.297253
TENNESSEE_TROUSDALE,296143584,5960709,1828.037842,3,302104293,98.026937,6.216107
TENNESSEE_UNICOI,481902940,825726,2711.472473,4,482728666,99.828946,6.790296
TENNESSEE_UNION,579064833,61018260,3858.63385,6,640083093,90.467135,7.108721
TENNESSEE_VAN BUREN,708142417,2893456,4547.53241,7,711035873,99.593065,6.523019
TENNESSEE_WARREN,1120619143,3524884,6393.620117,10,1124144027,99.686438,6.413731
TENNESSEE_WASHINGTON,845605992,8635316,7385.35321,11,854241308,98.989125,6.78252
TENNESSEE_WAYNE,1901333915,4023436,12192.6015,19,1905357351,99.788836,6.430738
TENNESSEE_WEAKLEY,1503107848,3707114,9143.19751,15,1506814962,99.753977,6.110498
TENNESSEE_WHITE,975592111,7113369,6418.689087,10,982705480,99.276144,6.46549
TENNESSEE_WILLIAMSON,1509623740,3001210,8425.219299,14,1512624950,99.801589,6.029978
TENNESSEE_WILSON,1479110611,32072445,9706.750732,16,1511183056,97.87766,6.198268
TEXAS_ANDERSON,2752201306,39808595,19876.77808,31,2792009901,98.574196,6.504607
TEXAS_ANDREWS,3886850260,957039,7540.78157,43,3887807299,99.975384,1.754102
TEXAS_ANGELINA,2066264544,173315133,13786.99518,21,2239579677,92.261265,7.115918
TEXAS_ARANSAS,652856775,714538201,2147.919495,4,1367394976,47.744564,11.246932
TEXAS_ARCHER,2339508173,57767712,15829.62439,25,2397275885,97.590277,6.488197
TEXAS_ARMSTRONG,2354581674,12219583,12543.56839,25,2366801257,99.483709,5.043466
TEXAS_ATASCOSA,3158596631,4995711,22215.22272,37,3163592342,99.842087,6.01361
TEXAS_AUSTIN,1674405698,25606399,10079.77856,17,1700012097,98.493752,6.019957
TEXAS_BAILEY,2141847187,1775275,8383.102722,23,2143622462,99.917183,3.647848
TEXAS_BANDERA,2048666866,17288358,10716.5332,20,2065955224,99.163178,5.403484
TEXAS_BASTROP,2300439612,19009781,15501.72083,26,2319449393,99.180418,6.011469
TEXAS_BAYLOR,2246764582,86991035,15706.28473,25,2333755617,96.272487,6.525763
TEXAS_BEE,2279809490,246409,14110.88806,26,2280055899,99.989193,5.427851
TEXAS_BELL,2723084632,94398906,17223.46539,30,2817483538,96.649531,5.940179
TEXAS_BEXAR,3212379601,40835789,23819.6438,37,3253215390,98.744756,6.519578
TEXAS_BLANCO,1836953627,10813162,10804.77679,18,1847766789,99.414798,6.037988
TEXAS_BORDEN,2324366073,22297606,7079.509933,25,2346663679,99.049817,2.858969
TEXAS_BOSQUE,2545908140,50666115,16241.76001,28,2596574255,98.048732,5.916067
TEXAS_BOWIE,2292144474,98320132,16088.33759,26,2390464606,95.886986,6.453245
TEXAS_BRAZORIA,3530854236,635436253,20942.71539,36,4166290489,84.748153,6.864363
TEXAS_BRAZOS,1518090963,13210254,9435.001709,16,1531301217,99.137318,5.948232
TEXAS_BREWSTER,16015869882,22063884,22149.04008,166,16037933766,99.862427,1.336118
TEXAS_BRISCOE,2330991073,4068657,13889.27728,25,2335059730,99.825758,5.565408
TEXAS_BROOKS,2443277014,741627,12079.28928,30,2444018641,99.969655,4.027652
TEXAS_BROWN,2446120247,32375524,16838.40424,28,2478495771,98.693743,6.09331
TEXAS_BURLESON,1706888861,46046458,10127.91065,17,1752935319,97.37318,6.11168
TEXAS_BURNET,2575162935,69894208,13399.92877,24,2645057143,97.357554,5.734844
TEXAS_CALDWELL,1412165279,4958570,9865.187195,15,1417123849,99.650096,6.599885
TEXAS_CALHOUN,1312707005,1361884774,5467.06665,10,2674591779,49.080649,11.138945
TEXAS_CALLAHAN,2329363239,4898783,13246.50604,25,2334262022,99.790136,5.309746
TEXAS_CAMERON,2309341040,996596429,9160.244629,23,3305937469,69.854347,5.701456
TEXAS_CAMP,507242994,19128743,3961.918579,6,526371737,96.365925,6.852212
TEXAS_CARSON,2383397227,10026604,11050.45367,25,2393423831,99.581077,4.438777
TEXAS_CASS,2426730190,60494083,18210.18549,29,2487224273,97.567807,6.435908
TEXAS_CASTRO,2316600395,12557414,11060.48129,25,2329157809,99.46086,4.448174
TEXAS_CHAMBERS,1546618329,709745142,9037.907349,15,2256363471,68.544734,8.794317
TEXAS_CHEROKEE,2727141730,23873001,20391.19537,31,2751014731,99.132211,6.635386
TEXAS_CHILDRESS,1803954627,44560655,11189.83801,20,1848515282,97.589381,5.733123
TEXAS_CLAY,2819870186,72508536,20212.70361,36,2892378722,97.493118,5.759012
TEXAS_COCHRAN,2007453828,229068,7415.436127,21,2007682896,99.98859,3.531563
TEXAS_COKE,2361153195,42331832,7333.209503,20,2403485027,98.238731,3.732341
TEXAS_COLEMAN,3270933226,47963343,18783.76593,36,3318896569,98.554841,5.294223
TEXAS_COLLIN,2179221397,115892956,12339.00452,22,2295114353,94.95045,5.906911
TEXAS_COLLINGSWORTH,2378749928,2279194,13204.38959,25,2381029122,99.904277,5.286817
TEXAS_COLORADO,2487129887,34703995,16500.4729,28,2521833882,98.623859,5.975254
TEXAS_COMAL,1449162144,39775861,8878.468079,13,1488938005,97.328575,7.017046
TEXAS_COMANCHE,2428768921,25719485,15932.90918,25,2454488406,98.952145,6.440652
TEXAS_CONCHO,2547914005,25740025,10517.98621,24,2573654030,98.999865,4.426768
TEXAS_COOKE,2265770199,61339004,11785.47986,20,2327109203,97.364154,6.052268
TEXAS_CORYELL,2725181904,11798688,16272.84564,29,2736980592,99.568916,5.63562
TEXAS_COTTLE,2332448739,2723997,14158.0174,25,2335172736,99.883349,5.669821
TEXAS_CRANE,2033319695,1695980,3119.597305,21,2035015675,99.91666,1.486762
TEXAS_CROCKETT,7270935061,53329,17333.76994,79,7270988390,99.999267,2.194164
TEXAS_CROSBY,2331503429,3873557,11258.02573,25,2335376986,99.834136,4.510692
TEXAS_CULBERSON,9873439554,556134,10545.06111,107,9873995688,99.994368,0.985575
TEXAS_DALLAM,3893095083,5180577,14348.54276,40,3898275660,99.867106,3.591909
TEXAS_DALLAS,2259439988,93869577,14036.68329,25,2353309565,96.011167,5.847938
TEXAS_DAWSON,2331781561,4720730,6197.0784,25,2336502291,99.797957,2.48385
TEXAS_DE WITT,3876750566,3926557,16960.74179,40,3880677123,99.898818,6.099503
TEXAS_DEAF SMITH,665192113,54648180,3761.365906,6,719840293,92.408291,4.588534
TEXAS_DELTA,2278094573,189918349,12649.86176,22,2468012922,92.304807,6.791567
TEXAS_DENTON,2354237927,3919919,15842.66071,26,2358157846,99.833772,5.759511
TEXAS_DICKENS,2335454676,9057848,11433.50931,23,2344512524,99.613658,4.990371
TEXAS_DIMMIT,3441795367,14576535,12381.12094,35,3456371902,99.578271,3.552445
TEXAS_DONLEY,2400676101,15901856,13321.71307,25,2416577957,99.341968,5.363982
TEXAS_DUVAL,4645084675,5478267,23030.46921,49,4650562942,99.882202,4.705639
TEXAS_EASTLAND,2399644792,14002299,16824.36639,28,2413647091,99.41987,6.043764
TEXAS_ECTOR,2325322369,10375045,3413.406975,23,2335697414,99.555805,1.490712
TEXAS_EDWARDS,5485259735,5199798,23061.55493,58,5490459533,99.905294,3.979899
TEXAS_EL PASO,2624297650,5293002,2506.908821,27,2629590652,99.798714,0.930357
TEXAS_ELLIS,2423348506,41667181,16261.8158,28,2465015687,98.309659,5.907651
TEXAS_ERATH,2805417368,17169065,17824.12134,29,2822586433,99.391726,6.183864
TEXAS_FALLS,1982545002,21693803,12429.25391,21,2004238805,98.917604,5.983457
TEXAS_FANNIN,2307251018,20847065,14863.96362,24,2328098083,99.104545,6.249278
TEXAS_FAYETTE,2460316895,25574677,14792.76782,25,2485891572,98.971207,5.978615
TEXAS_FISHER,2328272102,7258480,10590.1853,25,2335530582,99.689215,4.24928
TEXAS_FLOYD,2569637283,983737,12968.74057,25,2570621020,99.961732,5.189482
TEXAS_FOARD,1824378631,8514741,12670.91882,22,1832893372,99.535448,5.786389
TEXAS_FORT BEND,2231956074,61062478,14799.78662,25,2293018552,97.337026,6.081873
TEXAS_FRANKLIN,736570305,26874741,5869.174805,9,763445046,96.479807,6.759244
TEXAS_FREESTONE,2273311879,36936952,15689.23792,25,2310248831,98.40117,6.377663
TEXAS_FRIO,2935753506,2193622,14440.79694,32,2937947128,99.925335,4.516121
TEXAS_GAINES,3891105258,1262946,9227.429565,40,3892368204,99.967553,2.307606
TEXAS_GALVESTON,981349683,1281775597,3516.691589,6,2263125280,43.362588,13.557907
TEXAS_GARZA,2313930832,7215531,8568.614197,23,2321146363,99.689139,3.737102
TEXAS_GILLESPIE,2740729668,9002241,18344.55542,33,2749731909,99.672614,5.577215
TEXAS_GLASSCOCK,2331552974,2245302,4948.637848,24,2333798276,99.903792,2.063918
TEXAS_GOLIAD,2206698610,19050015,12336.99933,22,2225748625,99.144108,5.656137
TEXAS_GONZALES,2762704862,8204087,19086.60028,29,2770908949,99.703921,6.601131
TEXAS_GRAY,2398261679,8700790,12058.23096,25,2406962469,99.638516,4.840791
TEXAS_GRAYSON,2416026291,120082118,18736.63599,32,2536108409,95.265103,6.146216
TEXAS_GREGG,708052199,6206414,4655.830811,7,714258613,99.131069,6.709488
TEXAS_GRIMES,2039529235,36608889,13182.32849,22,2076138124,98.236683,6.099521
TEXAS_GUADALUPE,1842136094,9157035,13843.15009,19,1851293129,99.505371,7.322086
TEXAS_HALE,2602109427,246678,11892.77496,26,2602356105,99.990521,4.574578
TEXAS_HALL,2288233615,53366403,13820.08661,25,2341600018,97.720943,5.65696
TEXAS_HAMILTON,2165008734,1238628,14627.3111,23,2166247362,99.942821,6.363339
TEXAS_HANSFORD,2382296646,1548341,11154.74139,25,2383844987,99.935049,4.464797
TEXAS_HARDEMAN,1800337392,4548860,10656.3681,19,1804886252,99.74797,5.622786
TEXAS_HARDIN,2306612357,18037857,15111.6463,24,2324650214,99.224061,6.345758
TEXAS_HARRIS,4418909573,184757689,28250.85529,47,4603667262,95.986728,6.262137
TEXAS_HARRISON,2331138836,40651525,13624.54755,21,2371790361,98.286041,6.601019
TEXAS_HARTLEY,3786435508,3023183,15629.07196,41,3789458691,99.920221,3.815012
TEXAS_HASKELL,2339103809,18465208,14475.89349,25,2357569017,99.216769,5.836067
TEXAS_HAYS,1756075985,4940666,12547.57965,19,1761016651,99.719442,6.622569
TEXAS_HEMPHILL,2347270020,15205586,10678.42835,24,2362475606,99.356371,4.478168
TEXAS_HENDERSON,2263013491,193259090,13920.36298,22,2456272581,92.132018,6.867795
TEXAS_HIDALGO,4068395785,31102629,14180.07858,42,4099498414,99.241306,3.40202
TEXAS_HILL,2483426715,69544717,15848.67749,27,2552971432,97.27593,6.034258
TEXAS_HOCKLEY,2352723915,446119,9547.311371,25,2353170034,99.981042,3.819649
TEXAS_HOOD,1089630253,41775740,8285.834961,14,1131405993,96.307626,6.145363
TEXAS_HOPKINS,1987629163,65639829,14998.33368,23,2053268992,96.803155,6.736366
TEXAS_HOUSTON,3188278910,14435337,19567.92694,30,3202714247,99.549278,6.552174
TEXAS_HOWARD,2333039143,8841783,5900.260361,25,2341880926,99.62245,2.369048
TEXAS_HUDSPETH,11837605308,2189943,10345.51098,124,11839795251,99.981504,0.83447
TEXAS_HUNT,2176665528,107763045,16547.60376,27,2284428573,95.282713,6.432166
TEXAS_HUTCHINSON,2298408152,19507502,10366.569,24,2317915654,99.158403,4.356064
TEXAS_IRION,2723485995,176317,8733.067337,30,2723662312,99.993526,2.911211
TEXAS_JACK,2359323752,23786538,14829.86963,25,2383110290,99.00187,5.991753
TEXAS_JACKSON,2148246695,71039573,12513.48517,22,2219286268,96.79899,5.87604
TEXAS_JASPER,2431105363,80399907,17609.52997,28,2511505270,96.798736,6.497107
TEXAS_JEFF DAVIS,5865172239,206206,6420.694656,60,5865378445,99.996484,1.070153
TEXAS_JEFFERSON,2269793077,611960827,13937.40985,23,2881753904,78.764293,7.693516
TEXAS_JIM HOGG,2942674728,92565,12371.09332,33,2942767293,99.996854,3.748934
TEXAS_JIM WELLS,2240779223,8739522,10777.70203,22,2249518745,99.611494,4.918062
TEXAS_JOHNSON,1877798304,24427654,12277.83698,21,1902225958,98.715838,5.922645
TEXAS_JONES,2404986877,22187252,11938.90225,25,2427174129,99.085881,4.819618
TEXAS_KARNES,1936008333,15671661,12214.66211,19,1951679994,99.197017,6.480809
TEXAS_KAUFMAN,2021977077,69726012,16390.1695,27,2091703089,96.666544,6.279766
TEXAS_KENDALL,1715747627,1496797,10855.91797,18,1717244424,99.912837,6.036327
TEXAS_KENEDY,3777375652,1262209502,12798.27069,35,5039585154,74.954099,4.878517
TEXAS_KENT,2337482037,1065195,10391.63818,25,2338547232,99.954451,4.158549
TEXAS_KERR,2857603410,10245935,14302.41589,26,2867849345,99.642731,5.520653
TEXAS_KIMBLE,3240035979,493584,17591.47995,34,3240529563,99.984768,5.174753
TEXAS_KING,2359148814,6398044,14103.86859,25,2365546858,99.729532,5.656847
TEXAS_KINNEY,3522525626,13124948,9988.527161,35,3535650574,99.628783,2.864498
TEXAS_KLEBERG,2282572445,541041659,11944.9187,26,2823614104,80.838683,5.68317
TEXAS_KNOX,2203098612,12587673,12793.25635,21,2215686285,99.431884,6.126834
TEXAS_LA SALLE,3850545737,19503739,16683.97916,39,3870049476,99.496034,4.299612
TEXAS_LAMAR,2349626845,67098434,15552.86206,25,2416725279,97.22358,6.398802
TEXAS_LAMB,2631897589,3973764,12227.69809,30,2635871353,99.849243,4.082053
TEXAS_LAMPASAS,1846250642,2833490,13635.57788,24,1849084132,99.846763,5.69021
TEXAS_LAVACA,2511535250,1882216,14632.3255,25,2513417466,99.925113,5.857317
TEXAS_LEE,1629158370,13153181,10671.40924,18,1642311551,99.199106,5.976426
TEXAS_LEON,2779462025,19328383,18459.87323,30,2798790408,99.309402,6.196081
TEXAS_LIBERTY,3000095674,46626334,21697.79675,35,3046722008,98.469623,6.295719
TEXAS_LIMESTONE,2345053175,71830221,15236.99133,25,2416883396,97.027982,6.281483
TEXAS_LIPSCOMB,2414422645,298741,11406.43472,25,2414721386,99.987628,4.563138
TEXAS_LIVE OAK,2692796906,101483818,13015.87,23,2794280724,96.36816,5.872348
TEXAS_LLANO,2419185654,82370906,14632.32495,27,2501556560,96.707214,5.603904
TEXAS_LOVING,1732230054,19981167,1719.73941,17,1752211221,98.85966,1.02328
TEXAS_LUBBOCK,2319592469,13216115,10180.05493,25,2332808584,99.433468,4.095223
TEXAS_LYNN,2309924849,4169718,8421.207855,24,2314094567,99.819812,3.515171
TEXAS_MADISON,1207103453,16493254,8561.594849,14,1223596707,98.652068,6.198983
TEXAS_MARION,986485096,102144722,7039.399841,11,1088629818,90.61713,7.06208
TEXAS_MARTIN,2369724587,1931832,4805.242645,24,2371656419,99.918545,2.003817
TEXAS_MASON,2405674102,8755301,12350.035,24,2414429403,99.637376,5.164576
TEXAS_MATAGORDA,2830603629,1345784373,17423.01526,30,4176388002,67.776357,8.568876
TEXAS_MAVERICK,3313817729,31873432,10393.64374,35,3345691161,99.047329,2.998175
TEXAS_MCCULLOCH,2759893535,20286191,14756.66769,28,2780179726,99.270328,5.308977
TEXAS_MCLENNAN,2686203607,59812996,16642.86591,29,2746016603,97.821827,5.866706
TEXAS_MCMULLEN,2952065878,43985814,16892.55356,30,2996051692,98.531874,5.714751
TEXAS_MEDINA,3432663443,23762580,17516.2728,36,3456426023,99.31251,4.899314
TEXAS_MENARD,2336237982,613559,13337.7569,28,2336851541,99.973744,4.764736
TEXAS_MIDLAND,2331915364,4252951,4289.822174,25,2336168315,99.817952,1.719058
TEXAS_MILAM,2633815931,12741071,17337.78101,29,2646557002,99.518579,6.007466
TEXAS_MILLS,1937867073,4022965,13179.32068,21,1941890038,99.792833,6.288896
TEXAS_MITCHELL,2359710929,12489775,7192.822281,24,2372200704,99.473494,3.012872
TEXAS_MONTAGUE,2411034607,19087361,12164.5238,21,2430121968,99.214551,5.838489
TEXAS_MONTGOMERY,2699517016,89546861,18412.74341,30,2789063877,96.789358,6.341174
TEXAS_MOORE,2330207191,25699789,10182.06049,24,2355906980,98.909134,4.289316
TEXAS_MORRIS,652649031,17382447,2562.06073,4,670031478,97.405727,6.575745
TEXAS_MOTLEY,2562963902,644140,16487.43799,30,2563608042,99.974874,5.497194
TEXAS_NACOGDOCHES,2451572329,89731149,19225.9845,29,2541303478,96.46909,6.872305
TEXAS_NAVARRO,2614975609,197585893,18488.95337,30,2812561502,92.974877,6.628656
TEXAS_NEWTON,2418212542,15672146,17517.27588,28,2433884688,99.356085,6.296715
TEXAS_NOLAN,2362061742,5052159,9405.92157,24,2367113901,99.786569,3.927517
TEXAS_NUECES,2171176848,847308859,9403.916016,19,3018485707,71.92934,6.880961
TEXAS_OCHILTREE,2376792059,1331778,11488.66129,25,2378123837,99.943999,4.598039
TEXAS_OLDHAM,3886337115,2339716,16174.57513,40,3888676831,99.939833,4.046078
TEXAS_ORANGE,864501083,118476414,4882.455505,8,982977497,87.94719,6.939471
TEXAS_PALO PINTO,2467090693,85364144,15751.40894,26,2552454837,96.655606,6.267856
TEXAS_PANOLA,2101400909,25810622,14935.15942,23,2127211531,98.786645,6.573305
TEXAS_PARKER,2340624036,16510091,13610.50916,23,2357134127,99.299569,5.959354
TEXAS_PARMER,2281312149,11355762,9062.976624,23,2292667911,99.504692,3.960039
TEXAS_PECOS,12338274936,2532275,17258.56234,129,12340807211,99.97948,1.338148
TEXAS_POLK,2737733237,136271620,18608.28241,29,2874004857,95.258476,6.73604
TEXAS_POTTER,2352718727,35190087,10542.05255,25,2387908814,98.526322,4.279893
TEXAS_PRESIDIO,9985057448,1773188,12215.66483,103,9986830636,99.982245,1.186197
TEXAS_RAINS,594280898,76079674,3926.821838,6,670360572,88.650932,7.382554
TEXAS_RANDALL,2361896543,27215901,11488.6615,25,2389112444,98.860836,4.648418
TEXAS_REAGAN,3044049120,1792716,7089.537933,35,3045841836,99.941142,2.026775
TEXAS_REAL,1810812868,2346259,9950.422089,20,1813159127,99.870598,4.981657
TEXAS_RED RIVER,2703626782,33305606,17399.95252,28,2736932388,98.783105,6.290821
TEXAS_REEVES,6825534320,17396672,6409.664368,71,6842930992,99.745772,0.905071
TEXAS_REFUGIO,1995545556,123688759,10055.71234,19,2119234315,94.163517,5.620521
TEXAS_ROBERTS,2393298442,346846,11458.57855,26,2393645288,99.98551,4.407784
TEXAS_ROBERTSON,2214719307,26358041,12839.38385,22,2241077348,98.823867,5.905541
TEXAS_ROCKWALL,329224077,56057833,1146.158875,2,385281910,85.450178,6.706592
TEXAS_RUNNELS,2722259325,15604788,12698.99686,30,2737864113,99.430038,4.257264
TEXAS_RUSK,2393244509,37217198,17210.42957,26,2430461707,98.468719,6.722334
TEXAS_SABINE,1273523414,219936062,8283.829468,13,1493459476,85.273383,7.472644
TEXAS_SAN AUGUSTINE,1374395183,159644688,7720.276001,12,1534039871,89.593185,7.180862
TEXAS_SAN JACINTO,1474332268,151949233,10086.7981,16,1626281501,90.656646,6.953984
TEXAS_SAN PATRICIO,1795990944,37577389,9743.852753,19,1833568333,97.950587,5.235644
TEXAS_SAN SABA,2940447162,8069095,18630.34283,33,2948516257,99.726334,5.661051
TEXAS_SCHLEICHER,3394546067,87401,12954.70172,35,3394633468,99.997425,3.701439
TEXAS_SCURRY,2345090477,5436957,8406.166351,25,2350527434,99.768692,3.370262
TEXAS_SHACKELFORD,2367989254,3268209,14579.17865,25,2371257463,99.862174,5.83972
TEXAS_SHELBY,2060566172,101081674,13022.88947,20,2161647846,95.32386,6.830866
TEXAS_SHERMAN,2390195608,425429,11655.12021,27,2390621037,99.982204,4.31748
TEXAS_SMITH,2386604273,73163661,17224.46863,26,2459767934,97.025587,6.827885
TEXAS_SOMERVELL,482948955,14210911,2961.161011,5,497159866,97.141581,6.096588
TEXAS_STARR,3168019238,15346374,12052.21457,34,3183365612,99.51792,3.56194
TEXAS_STEPHENS,2322497228,64147705,15809.56928,25,2386644933,97.312223,6.498493
TEXAS_STERLING,2391722770,167451,7271.03833,27,2391890221,99.992999,2.693166
TEXAS_STONEWALL,2373238700,10177387,12705.01382,25,2383416087,99.572992,5.103799
TEXAS_SUTTON,3765674776,1277066,14461.85498,39,3766951842,99.966098,3.709426
TEXAS_SWISHER,2305502705,27277988,13129.18247,26,2332780693,98.830666,5.109432
TEXAS_TARRANT,2236863682,100074445,13343.77429,23,2336938127,95.717711,6.061199
TEXAS_TAYLOR,2371228266,9760311,10961.20758,25,2380988577,99.590073,4.40253
TEXAS_TERRELL,6107081791,259482,10768.6772,64,6107341273,99.995751,1.682677
TEXAS_TERRY,2302083289,5443860,8104.334686,25,2307527149,99.764083,3.2494
TEXAS_THROCKMORTON,2363499444,7586186,15657.14929,25,2371085630,99.680054,6.282962
TEXAS_TITUS,1051697794,50713653,6429.719421,10,1102411447,95.399753,6.739765
TEXAS_TOM GREEN,3941965407,48077315,14495.94911,40,3990042722,98.795068,3.668186
TEXAS_TRAVIS,2569870978,79794856,17287.64288,29,2649665834,96.988494,6.146354
TEXAS_TRINITY,1796924637,52256877,13719.81006,21,1849181514,97.174054,6.723238
TEXAS_TYLER,2394158696,29093511,14633.32788,23,2423252207,98.799402,6.439631
TEXAS_UPSHUR,1509910856,24878112,13346.78217,20,1534788968,98.379053,6.783345
TEXAS_UPTON,3215010598,464309,5486.119049,31,3215474907,99.98556,1.769971
TEXAS_UVALDE,4019455750,17385901,16647.87952,42,4036841651,99.569319,3.980926
TEXAS_VAL VERDE,8144863666,227711335,21989.60083,91,8372575001,97.280271,2.483998
TEXAS_VAN ZANDT,2182248065,44152062,13540.31561,21,2226400127,98.016886,6.578223
TEXAS_VICTORIA,2284644911,17425944,13921.36517,25,2302070855,99.243032,5.61102
TEXAS_WALKER,2031124893,44747191,14361.57904,23,2075872084,97.844415,6.381728
TEXAS_WALLER,1329330074,11827973,8348.005981,14,1341158047,99.118078,6.015917
TEXAS_WARD,2164201060,624206,2434.709808,24,2164825266,99.971166,1.014755
TEXAS_WASHINGTON,1564854987,45471813,11236.96753,19,1610326800,97.176237,6.087075
TEXAS_WEBB,8706186717,36555095,35538.94122,98,8742741812,99.581881,3.641649
TEXAS_WHARTON,2813117310,21287759,17546.3551,30,2834405069,99.248951,5.893045
TEXAS_WHEELER,2368629213,2455912,12015.11206,25,2371085125,99.896422,4.811028
TEXAS_WICHITA,1625459969,13644166,8155.475403,14,1639104135,99.167584,5.874238
TEXAS_WILBARGER,2514738098,18202665,12829.35626,23,2532940763,99.281362,5.618357
TEXAS_WILLACY,1529652132,502884780,5022.842346,15,2032536912,75.258271,4.449427
TEXAS_WILLIAMSON,2896486658,41622974,16925.6452,29,2938109632,98.583342,5.9203
TEXAS_WILSON,2081662852,12111366,16649.88501,24,2093774218,99.421553,6.977815
TEXAS_WINKLER,2178876165,19838,3110.572281,25,2178896003,99.99909,1.24424
TEXAS_WISE,2342369030,47038990,14240.24469,24,2389408020,98.031354,6.052589
TEXAS_WOOD,1671170961,130732368,10069.75098,15,1801903329,92.744762,7.238325
TEXAS_YOAKUM,2071252476,34329,6742.581787,22,2071286805,99.998343,3.064861
TEXAS_YOUNG,2368539760,42371869,16573.67505,26,2410911629,98.242496,6.488527
TEXAS_ZAPATA,2585876219,154370982,8529.506378,27,2740247201,94.366531,3.347666
TEXAS_ZAVALA,3360268878,11208707,12205.63721,35,3371477585,99.667543,3.498957
UTAH_BEAVER,6689681828,5298466,13025.89789,71,6694980294,99.920859,1.836087
UTAH_BOX ELDER,14881016779,2547651538,44284.04135,158,17428668317,85.382409,3.282629
UTAH_CACHE,3016638914,21097697,12803.2843,34,3037736611,99.30548,3.792008
UTAH_CARBON,3831067717,15844443,11700.24431,41,3846912160,99.588126,2.86552
UTAH_DAGGETT,1805185914,61230034,7274.046387,20,1866415948,96.719379,3.760387
UTAH_DAVIS,774573895,870620486,3097.536438,8,1645194381,47.080996,8.223956
UTAH_DUCHESNE,8379502732,38797805,28403.27588,89,8418300537,99.539125,3.206156
UTAH_EMERY,11557242836,24843848,18933.17757,121,11582086684,99.785498,1.568089
UTAH_GARFIELD,13403572592,85610782,23390.46124,141,13489183374,99.365338,1.669494
UTAH_GRAND,9512361695,31552270,18812.84587,100,9543913965,99.669399,1.887525
UTAH_IRON,8537474393,11390956,19936.9438,92,8548865349,99.866755,2.16995
UTAH_JUAB,8784407524,36542088,20163.56836,93,8820949612,99.585735,2.177145
UTAH_KANE,10333912584,306169204,20244.79198,110,10640081788,97.122492,1.894963
UTAH_MILLARD,17574363583,133311812,31258.14375,185,17707675395,99.247152,1.702446
UTAH_MORGAN,1577739404,4437369,6434.733337,16,1582176773,99.71954,4.033019
UTAH_PIUTE,1964345824,20285697,4984.737289,21,1984631521,98.977861,2.398197
UTAH_RICH,2664700960,149106532,10350.52487,28,2813807492,94.700898,3.894305
UTAH_SALT LAKE,1921943552,164903045,9408.929901,25,2086846597,92.09798,4.086487
UTAH_SAN JUAN,20253296804,293696059,36390.28706,219,20546992863,98.570613,1.685753
UTAH_SANPETE,4117901464,32049371,12408.19553,46,4149950835,99.227717,2.718428
UTAH_SEVIER,4948000018,20260738,11813.55669,52,4968260756,99.592197,2.28114
UTAH_SUMMIT,4844777278,26617166,22874.03799,53,4871394444,99.453603,4.339568
UTAH_TOOELE,17979556883,891073714,44769.37856,190,18870630597,95.277987,2.473061
UTAH_UINTAH,11609319514,56115726,28289.96356,123,11665435240,99.518957,2.311114
UTAH_UTAH,5190511352,363000373,20290.9195,54,5553511725,93.463589,4.020365
UTAH_WASATCH,3048454179,79128329,13499.20206,31,3127582508,97.469984,4.467613
UTAH_WASHINGTON,6287037025,7781671,16030.17731,66,6294818696,99.87638,2.431821
UTAH_WAYNE,6374011496,15049641,10007.57964,68,6389061137,99.764447,1.475178
UTAH_WEBER,1492536927,216443479,5808.006134,15,1708980406,87.334935,4.433511
VERMONT_ADDISON,1984780267,107303387,13513.24097,22,2092083654,94.87098,6.474459
VERMONT_BENNINGTON,1748232505,6928230,11954.94641,19,1755160735,99.605265,6.317013
VERMONT_CALEDONIA,1680952571,22385533,10615.25488,18,1703338104,98.685785,5.9759
VERMONT_CHITTENDEN,1389750174,214227544,9088.045532,15,1603977718,86.643983,6.992635
VERMONT_ESSEX,1718713996,28676219,11986.03192,20,1747390215,98.358912,6.093008
VERMONT_FRANKLIN,1642369811,150194261,11049.45062,18,1792564072,91.621261,6.699955
VERMONT_GRAND ISLE,211881634,292317316,1868.148376,3,504198950,42.023418,14.818312
VERMONT_LAMOILLE,1188468700,12662636,7124.63501,12,1201131336,98.945774,6.000454
VERMONT_ORANGE,1779395566,12010320,10814.80444,18,1791405886,99.329559,6.049221
VERMONT_ORLEANS,1796347026,71471454,11474.62256,19,1867818480,96.173533,6.27956
VERMONT_RUTLAND,2408219235,38751950,14953.20929,24,2446971185,98.41633,6.330762
VERMONT_WASHINGTON,1779432159,21173948,11249.00092,19,1800606107,98.824066,5.990977
VERMONT_WINDHAM,2034457838,32920750,13102.10815,21,2067378588,98.407609,6.340058
VERMONT_WINDSOR,2511196442,19360407,17295.6648,28,2530556849,99.234935,6.224646
VIRGINIA_ACCOMACK,1163708393,2229277504,3180.765808,5,3392985897,34.297472,18.548106
VIRGINIA_ALBEMARLE,1866007829,14230114,12120.40222,20,1880237943,99.243175,6.106416
VIRGINIA_ALEXANDRIA,38679383,1070216,251.844626,0.41895,39749599,97.307606,6.177693
VIRGINIA_ALLEGHANY,1156608818,8170515,7625.013489,12,1164779333,99.298535,6.399065
VIRGINIA_AMELIA,920379346,8188217,5453.028076,9,928567563,99.118188,6.112824
VIRGINIA_AMHERST,1227554628,12898694,7239.952271,12,1240453322,98.960163,6.096689
VIRGINIA_APPOMATTOX,865622498,3219010,5963.43457,10,868841508,99.629506,5.985611
VIRGINIA_ARLINGTON,67332991,273562,429.270895,0.712555,67606553,99.595362,6.048838
VIRGINIA_AUGUSTA,2504708348,9537633,17034.94635,27,2514245981,99.620656,6.333264
VIRGINIA_BATH,1370626056,14039993,9131.164551,14,1384666049,98.986038,6.589071
VIRGINIA_BEDFORD,1968605128,42118517,13829.11096,23,2010723645,97.905306,6.141298
VIRGINIA_BLAND,926311270,2547183,6642.305359,10,928858453,99.725773,6.66057
VIRGINIA_BOTETOURT,1401900525,12124670,9202.360718,15,1414025195,99.142542,6.187966
VIRGINIA_BRISTOL,33420176,322409,239.269629,0.355638,33742585,99.044504,6.792818
VIRGINIA_BRUNSWICK,1466538259,8383474,10264.28711,16,1474921733,99.431599,6.451852
VIRGINIA_BUCHANAN,1302386904,2804451,8578.641479,13,1305191355,99.785131,6.613165
VIRGINIA_BUCKINGHAM,1501215438,9911855,10122.89734,17,1511127293,99.344075,5.993961
VIRGINIA_BUENA VISTA,16674748,219580,110.056383,0.178062,16894328,98.700274,6.262098
VIRGINIA_CAMPBELL,1303300941,8894442,7745.345337,13,1312195383,99.322171,5.998618
VIRGINIA_CAROLINE,1366502847,24928486,8410.177368,14,1391431333,98.208429,6.116857
VIRGINIA_CARROLL,1229582397,7586189,8398.144226,13,1237168586,99.38681,6.499968
VIRGINIA_CHARLES CITY,473711563,55274680,3253.967529,5,528986243,89.550828,7.267309
VIRGINIA_CHARLOTTE,1231010119,5809378,7882.72406,13,1236819497,99.530297,6.092249
VIRGINIA_CHARLOTTESVILLE,26533570,47161,169.597482,0.280154,26580731,99.822574,6.064502
VIRGINIA_CHESAPEAKE,876737871,32209979,7096.557373,10,908947850,96.456345,7.357274
VIRGINIA_CHESTERFIELD,1097006029,34782834,8131.409058,13,1131788863,96.926738,6.453255
VIRGINIA_CLARKE,455664148,5690610,2487.856262,4,461354758,98.766544,6.297315
VIRGINIA_COLONIAL HEIGHTS,19475232,766910,137.976481,0.213347,20242142,96.21132,6.722035
VIRGINIA_COVINGTON,14163842,521492,98.082029,0.15478,14685334,96.448892,6.570146
VIRGINIA_CRAIG,849770459,2793174,5012.814941,8,852563633,99.672379,6.286615
VIRGINIA_CULPEPER,982089164,9005140,6650.327454,11,991094304,99.091394,6.101188
VIRGINIA_CUMBERLAND,770525893,5917833,4177.512817,7,776443726,99.237828,6.01371
VIRGINIA_DANVILLE,110844523,2341364,1225.377075,2,113185887,97.931399,6.256303
VIRGINIA_DICKENSON,855863022,8079113,5966.44281,9,863942135,99.064855,6.69196
VIRGINIA_DINWIDDIE,1305053884,8992266,8389.119446,13,1314046150,99.315681,6.497633
VIRGINIA_EMPORIA,17881071,165621,128.527771,0.190207,18046692,99.082264,6.819926
VIRGINIA_ESSEX,665855329,74795284,4804.239624,8,740650613,89.901408,6.679873
VIRGINIA_FAIRFAX,1012703532,40107717,7158.728882,12,1052811249,96.190417,6.201873
VIRGINIA_FALLS CHURCH,5300262,32,33.610817,0.055864,5300294,99.999396,6.016618
VIRGINIA_FAUQUIER,1678327963,9633564,11412.45148,19,1687961527,99.429278,6.041031
VIRGINIA_FLOYD,986585626,2190752,6976.225769,11,988776378,99.778438,6.356106
VIRGINIA_FLUVANNA,743630413,10747024,4786.190186,8,754377437,98.575378,6.069201
VIRGINIA_FRANKLIN,1788703111,54373109,11623.03137,19,1843076220,97.049872,6.303342
VIRGINIA_FREDERICK,1070102010,5935110,7716.265076,12,1076037120,99.448429,6.465885
VIRGINIA_FREDERICKSBURG,27067167,177679,170.752524,0.287153,27244846,99.347844,5.985422
VIRGINIA_GALAX,21332076,105290,147.02026,0.225944,21437366,99.508848,6.53905
VIRGINIA_GILES,925205239,11234368,6525.98468,10,936439607,98.80031,6.605227
VIRGINIA_GLOUCESTER,564124717,181747503,3227.895752,5,745872220,75.63289,8.535693
VIRGINIA_GOOCHLAND,726830013,21963167,5389.853699,9,748793180,97.066858,6.169692
VIRGINIA_GRAYSON,1144218808,9792929,7877.710144,12,1154011737,99.151401,6.620944
VIRGINIA_GREENE,403865093,1680243,2466.798218,4,405545336,99.585683,6.192653
VIRGINIA_GREENSVILLE,764634553,4086108,4735.049133,7,768720661,99.468453,6.800504
VIRGINIA_HALIFAX,2117913131,30524580,15976.02808,26,2148437711,98.57922,6.233186
VIRGINIA_HAMPTON,133275943,219727565,909.243259,1.3043,353003508,37.754849,18.43367
VIRGINIA_HANOVER,1211818311,12652671,5485.115967,9,1224470982,98.966683,6.158207
VIRGINIA_HARRISONBURG,44908386,131080,300.111914,0.474704,45039466,99.708966,6.340541
VIRGINIA_HENRICO,605218124,28895008,4969.695862,8,634113132,95.443241,6.508706
VIRGINIA_HENRY,990284619,5269785,6156.967896,10,995554404,99.470668,6.189732
VIRGINIA_HIGHLAND,1075266902,1791758,7995.033264,12,1077058660,99.833643,6.67363
VIRGINIA_HOPEWELL,26817671,1228128,192.407603,0.295595,28045799,95.620991,6.80698
VIRGINIA_ISLE OF WIGHT,817607278,122113383,4167.485229,6,939720661,87.005353,7.983197
VIRGINIA_JAMES CITY,368724192,95246387,1972.435852,3,463970579,79.47146,8.273141
VIRGINIA_KING AND QUEEN,816268317,28893747,5603.442139,9,845162064,96.581277,6.446432
VIRGINIA_KING GEORGE,465234034,21087162,2975.199463,5,486321196,95.663943,6.220106
VIRGINIA_KING WILLIAM,709469217,31143712,4990.753845,8,740612929,95.794873,6.512292
VIRGINIA_LANCASTER,345238878,254114185,1862.131897,3,599353063,57.601921,10.775867
VIRGINIA_LEE,1127622392,4896871,6596.178284,10,1132519263,99.567613,6.624823
VIRGINIA_LEXINGTON,6473000,67783,42.926876,0.068938,6540783,98.963687,6.292111
VIRGINIA_LOUDOUN,1335826412,14423208,8528.503784,14,1350249620,98.931812,6.157563
VIRGINIA_LOUISA,1284976751,37794135,9608.480591,16,1322770886,97.142806,6.18193
VIRGINIA_LUNENBURG,1118097709,1743628,7391.36969,12,1119841337,99.844297,6.16908
VIRGINIA_LYNCHBURG,126842532,1428787,1193.288574,2,128271319,98.886121,6.03365
VIRGINIA_MADISON,830447699,3207612,4325.921753,7,833655311,99.615235,6.203758
VIRGINIA_MANASSAS,25509473,146287,159.168918,0.270405,25655760,99.429808,5.920081
VIRGINIA_MANASSAS PARK,6538719,616,40.638141,0.068923,6539335,99.99058,5.896698
VIRGINIA_MARTINSVILLE,28376610,133615,185.338979,0.30049,28510225,99.531344,6.196931
VIRGINIA_MATHEWS,222506456,430073260,594.595583,0.920231,652579716,34.096441,18.947846
VIRGINIA_MECKLENBURG,1619544361,139655805,10705.5033,17,1759200166,92.061403,6.840385
VIRGINIA_MIDDLESEX,337554148,208310591,916.679354,1.445463,545864739,61.838423,10.253313
VIRGINIA_MONTGOMERY,1001921573,6289787,6392.617371,10,1008211360,99.376144,6.432748
VIRGINIA_NELSON,1219224530,8983980,7877.7099,13,1228208510,99.26853,6.104429
VIRGINIA_NEW KENT,543990076,35597682,3860.639526,6,579587758,93.858103,6.855454
VIRGINIA_NEWPORT NEWS,178689012,131135113,1375.791504,2,309824125,57.674338,11.927241
VIRGINIA_NORFOLK,137981426,111701531,1414.899292,2,249682957,55.262653,12.801587
VIRGINIA_NORTHAMPTON,548349606,1511350585,1950.374939,3,2059700191,26.622788,24.419869
VIRGINIA_NORTHUMBERLAND,495828046,243886813,3059.431396,5,739714859,67.029618,9.128596
VIRGINIA_NORTON,19366113,89335,136.532927,0.205055,19455448,99.540823,6.689064
VIRGINIA_NOTTOWAY,814265583,4297830,5524.223938,9,818563413,99.474955,6.170424
VIRGINIA_ORANGE,883475383,6501368,5440.994812,9,889976751,99.26949,6.090038
VIRGINIA_PAGE,802949703,8369920,5649.569641,9,811319623,98.968357,6.342734
VIRGINIA_PATRICK,1250846143,7141128,8752.119812,14,1257987271,99.432337,6.287204
VIRGINIA_PETERSBURG,58845276,578133,408.285738,0.626307,59423409,99.027096,6.582997
VIRGINIA_PITTSYLVANIA,2509705662,23903850,13903.3158,23,2533609512,99.05653,6.102495
VIRGINIA_POQUOSON,39837595,163455830,7.951709,0.011509,203293425,19.596106,35.257212
VIRGINIA_PORTSMOUTH,86248210,34658275,489.270079,0.69508,120906485,71.334643,9.870171
VIRGINIA_POWHATAN,673927665,5437786,4198.570801,7,679365451,99.199579,6.046355
VIRGINIA_PRINCE EDWARD,906395971,10040115,6030.619934,10,916436086,98.904439,6.097421
VIRGINIA_PRINCE GEORGE,687232237,42745198,5329.687988,8,729977435,94.144312,7.076487
VIRGINIA_PRINCE WILLIAM,869574665,30876519,5304.619507,9,900451184,96.570995,6.103304
VIRGINIA_PULASKI,828377036,24877882,4565.582092,7,853254918,97.084355,6.718137
VIRGINIA_RADFORD,25061727,858287,176.233192,0.27319,25920014,96.688709,6.671854
VIRGINIA_RAPPAHANNOCK,689900924,2142396,4303.860901,7,692043320,99.690425,6.167466
VIRGINIA_RICHMOND,495925425,64458631,3631.006714,6,560384056,88.497419,6.843919
VIRGINIA_ROANOKE,648906307,1762677,3712.230591,6,650668984,99.729098,6.163638
VIRGINIA_ROCKBRIDGE,1545038073,8836972,10619.26544,17,1553875045,99.431295,6.282355
VIRGINIA_ROCKINGHAM,2200943610,10647709,15225.96124,24,2211591319,99.51855,6.374842
VIRGINIA_RUSSELL,1226420311,7550968,7964.950378,12,1233971279,99.388076,6.678325
VIRGINIA_SALEM,37602710,275156,246.282435,0.399222,37877866,99.27357,6.214184
VIRGINIA_SCOTT,1387786298,8105326,9963.457947,15,1395891624,99.419344,6.681099
VIRGINIA_SHENANDOAH,1315900415,9735885,8954.677979,14,1325636300,99.265569,6.443522
VIRGINIA_SMYTH,1168992137,3519017,8647.832397,13,1172511154,99.699873,6.672204
VIRGINIA_SOUTHAMPTON,1551909771,8090234,11102.59753,16,1560000005,99.481395,6.975298
VIRGINIA_SPOTSYLVANIA,1039889019,33115177,6589.15918,11,1073004196,96.913789,6.1809
VIRGINIA_STAFFORD,697237202,28088011,4731.038574,8,725325213,96.127529,6.152034
VIRGINIA_STAUNTON,51593819,147694,341.773452,0.545342,51741513,99.714554,6.28508
VIRGINIA_SUFFOLK,1033802703,77061976,7738.325928,11,1110864679,93.062884,7.559235
VIRGINIA_SURRY,722475750,81216905,4813.264587,7,803692655,89.894532,7.649066
VIRGINIA_SUSSEX,1269679003,6740704,10206.12695,15,1276419707,99.471905,6.840207
VIRGINIA_TAZEWELL,1343661944,2921322,9302.636902,14,1346583266,99.783057,6.659187
VIRGINIA_VIRGINIA BEACH,633828557,654687358,3577.860229,5,1288515915,49.190588,14.549988
VIRGINIA_WARREN,555641045,8578483,3764.374146,6,564219528,98.479584,6.37082
VIRGINIA_WASHINGTON,1453399740,12984238,10692.46716,16,1466383978,99.11454,6.742494
VIRGINIA_WAYNESBORO,38771594,364644,254.382449,0.412485,39136238,99.06827,6.225067
VIRGINIA_WESTMORELAND,593950700,61109888,2406.632385,4,655060588,90.671109,6.63561
VIRGINIA_WILLIAMSBURG,23155310,416905,165.480573,0.248445,23572215,98.231371,6.780581
VIRGINIA_WINCHESTER,23809495,54462,160.365523,0.25152,23863957,99.771781,6.390464
VIRGINIA_WISE,1044903124,5257728,7323.181946,11,1050160852,99.499341,6.690937
VIRGINIA_WYTHE,1196377810,7305107,9256.509949,14,1203682917,99.393104,6.652165
VIRGINIA_YORK,270935371,285552364,2024.57959,3,556487735,48.686674,13.861285
WASHINGTON_ADAMS,4985698857,12464425,14729.59277,54,4998163282,99.75062,2.734522
WASHINGTON_ASOTIN,1647427904,11291738,6915.057068,16,1658719642,99.31925,4.351534
WASHINGTON_BENTON,4403230415,154373080,9976.493973,46,4557603495,96.612845,2.244839
WASHINGTON_CHELAN,7565817923,189650482,36195.75119,79,7755468405,97.554622,4.69659
WASHINGTON_CLALLAM,4503168731,2409553970,26714.62134,46,6912722701,65.143199,8.915016
WASHINGTON_CLARK,1627765527,70227538,10547.06635,19,1697993065,95.864086,5.790581
WASHINGTON_COLUMBIA,2249624769,12561759,9103.087097,24,2262186528,99.444707,3.814133
WASHINGTON_COWLITZ,2955625058,65415995,17875.26196,31,3021041053,97.834654,5.893835
WASHINGTON_DOUGLAS,4711869840,76507216,16113.40659,53,4788377056,98.402231,3.089631
WASHINGTON_FERRY,5706361267,140294385,28710.12143,62,5846655652,97.600434,4.744512
WASHINGTON_FRANKLIN,3215718490,60508744,7906.790237,34,3276227234,98.153097,2.369285
WASHINGTON_GARFIELD,1841054899,19294817,8755.128113,22,1860349716,98.962839,4.021311
WASHINGTON_GRANT,6939874184,289941148,17464.12909,76,7229815332,95.989647,2.393916
WASHINGTON_GRAYS HARBOR,4924766221,834338731,33623.6626,51,5759104952,85.512701,7.70982
WASHINGTON_ISLAND,540043816,799820903,3102.550232,5,1339864719,40.305846,15.395038
WASHINGTON_JEFFERSON,4671624000,995002318,28932.73541,47,5666626318,82.441011,7.468331
WASHINGTON_KING,5478557088,497719285,35179.95163,59,5976276373,91.671749,6.504407
WASHINGTON_KITSAP,1023372595,442123262,6467.824463,10,1465495857,69.831149,9.262091
WASHINGTON_KITTITAS,5950002896,92410114,22991.36119,62,6042413010,98.470642,3.765878
WASHINGTON_KLICKITAT,4847515963,84930593,17153.27245,52,4932446556,98.278124,3.356501
WASHINGTON_LEWIS,6223179711,86925423,37796.16168,67,6310105134,98.622441,5.720015
WASHINGTON_LINCOLN,5984421213,75265957,20967.78476,63,6059687170,98.757923,3.370079
WASHINGTON_MASON,2485238914,236949795,16341.03412,26,2722188709,91.295615,6.878871
WASHINGTON_OKANOGAN,13639362794,120413445,67957.28232,146,13759776239,99.124888,4.695701
WASHINGTON_PACIFIC,2418037181,758680709,15337.2674,23,3176717890,76.117467,8.76064
WASHINGTON_PEND OREILLE,3626653301,65382423,20197.6622,41,3692035724,98.229096,5.015071
WASHINGTON_PIERCE,4320226613,355894389,28458.42822,48,4676121002,92.389111,6.396367
WASHINGTON_SAN JUAN,450429127,1157481619,557.53656,1,1607910746,28.013317,19.902555
WASHINGTON_SKAGIT,4481252102,483846689,26864.03415,47,4965098791,90.255044,6.328871
WASHINGTON_SKAMANIA,4294930645,73290050,23219.99176,46,4368220695,98.322199,5.133962
WASHINGTON_SNOHOMISH,5404072228,282898666,34027.77649,58,5686970894,95.025495,6.173983
WASHINGTON_SPOKANE,4568463940,43423106,21186.38702,48,4611887046,99.058453,4.455784
WASHINGTON_STEVENS,6416424160,163015693,31920.97022,68,6579439853,97.522347,4.813523
WASHINGTON_THURSTON,1871240012,133644618,10895.02539,18,2004884630,93.334049,6.485084
WASHINGTON_WAHKIAKUM,680962890,61582307,5155.20697,8,742545197,91.706591,7.026767
WASHINGTON_WALLA WALLA,3289368965,74933658,10946.16646,36,3364302623,97.772684,3.109868
WASHINGTON_WHATCOM,5459374970,1028230391,34103.98694,60,6487605361,84.150849,6.749653
WASHINGTON_WHITMAN,5592461103,48248847,22825.90549,58,5640709950,99.144632,3.969454
WASHINGTON_YAKIMA,11122733955,41189156,40587.85506,117,11163923111,99.631051,3.481894
WEST VIRGINIA_BARBOUR,883338380,4639586,7370.311646,11,887977966,99.477511,6.735475
WEST VIRGINIA_BERKELEY,831770844,1057606,5830.066711,9,832828450,99.87301,6.486089
WEST VIRGINIA_BOONE,1298967362,4305989,8408.171814,13,1303273351,99.669602,6.489265
WEST VIRGINIA_BRAXTON,1322796519,14344826,9943.402771,15,1337141345,98.927202,6.700821
WEST VIRGINIA_BROOKE,231015798,8732460,1344.705872,2,239748258,96.357654,6.977681
WEST VIRGINIA_CABELL,727837358,18122698,5098.049744,8,745960056,97.570554,6.531235
WEST VIRGINIA_CALHOUN,723252961,3704011,4601.681763,7,726956972,99.490477,6.607498
WEST VIRGINIA_CLAY,885617251,4862447,5868.171875,9,890479698,99.453952,6.55599
WEST VIRGINIA_DODDRIDGE,828078405,1950541,5397.875916,8,830028946,99.765003,6.763238
WEST VIRGINIA_FAYETTE,1713569366,17443841,12381.12067,19,1731013207,98.992276,6.582715
WEST VIRGINIA_GILMER,876717626,4082112,6006.553223,9,880799738,99.536545,6.705023
WEST VIRGINIA_GRANT,1236388353,7545525,9246.482056,14,1243933878,99.393414,6.644937
WEST VIRGINIA_GREENBRIER,2641303483,12164256,18901.08887,29,2653467739,99.541571,6.547633
WEST VIRGINIA_HAMPSHIRE,1658633563,10902925,13160.26794,20,1669536488,99.346949,6.623388
WEST VIRGINIA_HANCOCK,213957103,13879340,1609.662569,2.401335,227836443,93.9082,7.138039
WEST VIRGINIA_HARDY,1508191847,5622361,9130.16156,14,1513814208,99.628596,6.545856
WEST VIRGINIA_HARRISON,1077454934,1320319,8120.378723,12,1078775253,99.877609,6.775275
WEST VIRGINIA_JACKSON,1202685084,18828941,9151.219788,14,1221514025,98.458557,6.638921
WEST VIRGINIA_JEFFERSON,542073026,6150169,3170.73822,5,548223195,98.878163,6.413425
WEST VIRGINIA_KANAWHA,2335215669,24056475,14948.19501,23,2359272144,98.980343,6.566168
WEST VIRGINIA_LEWIS,1002141346,7038764,6755.617737,10,1009180110,99.302526,6.803067
WEST VIRGINIA_LINCOLN,1131929493,4019060,8998.799194,14,1135948553,99.646193,6.449762
WEST VIRGINIA_LOGAN,1175258983,4780836,9054.953979,14,1180039819,99.594858,6.494135
WEST VIRGINIA_MARION,799666879,7161744,5381.831787,8,806828623,99.112359,6.787539
WEST VIRGINIA_MARSHALL,791063492,17411505,4684.911072,7,808474997,97.846377,6.840039
WEST VIRGINIA_MASON,1115682321,36125493,8344.997803,13,1151807814,96.863583,6.627082
WEST VIRGINIA_MCDOWELL,1381648552,3731571,10536.03589,16,1385380123,99.730646,6.602807
WEST VIRGINIA_MERCER,1085106039,4442450,7277.054504,11,1089548489,99.592267,6.642588
WEST VIRGINIA_MINERAL,849172613,3503402,6001.539612,9,852676015,99.589129,6.695889
WEST VIRGINIA_MINGO,1095926641,2177833,6482.865784,10,1098104474,99.801673,6.495749
WEST VIRGINIA_MONONGALIA,932631311,14993106,6744.587341,10,947624417,98.417822,6.853014
WEST VIRGINIA_MONROE,1224426776,2297599,9027.879822,14,1226724375,99.812705,6.460586
WEST VIRGINIA_MORGAN,593295473,1401571,3948.882568,6,594697044,99.764322,6.597019
WEST VIRGINIA_NICHOLAS,1675324339,19580622,11790.49335,18,1694904961,98.844736,6.626831
WEST VIRGINIA_OHIO,274098954,8274294,2677.378601,4,282373248,97.069732,6.895503
WEST VIRGINIA_PENDLETON,1802759655,5429034,13180.32349,20,1808188689,99.699753,6.610008
WEST VIRGINIA_PLEASANTS,337007574,11468023,2625.234741,4,348475597,96.709089,6.786422
WEST VIRGINIA_POCAHONTAS,2435206760,4094092,14885.02155,22,2439300852,99.832161,6.777294
WEST VIRGINIA_PRESTON,1680419586,6668879,10746.61646,16,1687088465,99.604711,6.743291
WEST VIRGINIA_PUTNAM,895302723,12226547,5145.179321,8,907529270,98.652766,6.52001
WEST VIRGINIA_RALEIGH,1567869626,10331212,11114.63037,17,1578200838,99.34538,6.581099
WEST VIRGINIA_RANDOLPH,2692810851,667359,19044.48425,28,2693478210,99.975223,6.803287
WEST VIRGINIA_RITCHIE,1170648846,4424611,8646.829529,13,1175073457,99.623461,6.676547
WEST VIRGINIA_ROANE,1252422373,404682,9148.211304,14,1252827055,99.967698,6.536548
WEST VIRGINIA_SUMMERS,933930185,18478164,5898.254822,9,952408349,98.059849,6.683282
WEST VIRGINIA_TAYLOR,447475051,7532835,4014.062256,6,455007886,98.344461,6.802726
WEST VIRGINIA_TUCKER,1085320037,5303786,7998.041809,12,1090623823,99.513692,6.697606
WEST VIRGINIA_TYLER,663818549,11382159,5332.696228,8,675200708,98.314255,6.780167
WEST VIRGINIA_UPSHUR,918506902,302703,7431.480408,11,918809605,99.967055,6.758118
WEST VIRGINIA_WAYNE,1310550727,15814102,8944.650574,14,1326364829,98.807711,6.466131
WEST VIRGINIA_WEBSTER,1433481441,7144591,10125.90558,15,1440626032,99.504063,6.784249
WEST VIRGINIA_WETZEL,927389120,8449879,6735.562439,10,935838999,99.09708,6.796933
WEST VIRGINIA_WIRT,602201079,5839710,3937.852356,6,608040789,99.039586,6.626731
WEST VIRGINIA_WOOD,949251416,26569123,6520.971008,10,975820539,97.277253,6.70349
WEST VIRGINIA_WYOMING,1293620915,6083317,9155.230652,14,1299704232,99.531946,6.570203
WISCONSIN_ADAMS,1672216056,108348981,13926.37946,21,1780565037,93.91491,7.061295
WISCONSIN_ASHLAND,2706476265,3230710866,15618.04144,25,5937187131,45.58516,13.70365
WISCONSIN_BARRON,2235266753,69209178,15357.32306,23,2304475931,96.99675,6.883836
WISCONSIN_BAYFIELD,3827675487,1460302486,21838.18402,35,5287977973,72.384482,8.619915
WISCONSIN_BROWN,1372933170,221808933,7783.450012,12,1594742103,86.091235,7.53411
WISCONSIN_BUFFALO,1750289306,87551031,15603.00006,23,1837840337,95.2362,7.12325
WISCONSIN_BURNETT,2127832846,151938089,17004.8631,26,2279770935,93.335379,7.007345
WISCONSIN_CALUMET,824344287,204080864,5233.422607,8,1028425151,80.155983,8.16131
WISCONSIN_CHIPPEWA,2611628480,85233307,19518.79175,29,2696861787,96.839537,6.950279
WISCONSIN_CLARK,3133097725,23243273,22140.01538,33,3156340998,99.263601,6.758868
WISCONSIN_COLUMBIA,1982756265,78834952,14117.90729,21,2061591217,96.176014,6.990114
WISCONSIN_CRAWFORD,1477970890,73976421,11145.71619,16,1551947311,95.233316,7.314743
WISCONSIN_DANE,3098882969,106233254,21139.25726,31,3205116223,96.68551,7.052882
WISCONSIN_DODGE,2268044939,81336171,16732.11145,25,2349381110,96.537975,6.932862
WISCONSIN_DOOR,1248277426,4890604606,5677.646973,9,6138882032,20.333954,31.074447
WISCONSIN_DOUGLAS,3378102279,454239392,20853.47009,33,3832341671,88.14721,7.168954
WISCONSIN_DUNN,2201905281,35570217,15480.66303,23,2237475498,98.410252,6.839453
WISCONSIN_EAU CLAIRE,1652211280,18848534,10810.79346,16,1671059814,98.872061,6.833827
WISCONSIN_FLORENCE,1264232458,24111637,7885.732361,13,1288344095,98.128478,6.181639
WISCONSIN_FOND DU LAC,1863667187,119853825,14588.20349,22,1983521012,93.957522,7.057446
WISCONSIN_FOREST,2626878506,83594186,17802.06012,29,2710472692,96.915882,6.333989
WISCONSIN_GRANT,2970402180,94521617,23881.81543,34,3064923797,96.916021,7.247577
WISCONSIN_GREEN,1512667089,1313320,11088.55872,16,1513980409,99.913254,6.936366
WISCONSIN_GREEN LAKE,905314776,79202663,7915.815063,12,984517439,91.955179,7.173617
WISCONSIN_IOWA,1975379914,13870324,13270.57208,19,1989250238,99.302736,7.033554
WISCONSIN_IRON,1963751253,416872439,14203.14252,23,2380623692,82.48894,7.482779
WISCONSIN_JACKSON,2558687761,32538303,18251.29846,27,2591226064,98.744289,6.845702
WISCONSIN_JEFFERSON,1441306090,67988035,10783.71875,16,1509294125,95.495375,7.057749
WISCONSIN_JUNEAU,1986729546,98638537,12747.12964,19,2085368083,95.26997,7.042109
WISCONSIN_KENOSHA,704075246,1248841319,5381.831726,8,1952916565,36.0525,18.659207
WISCONSIN_KEWAUNEE,886951818,1921336270,5874.188538,9,2808288088,31.583363,20.665552
WISCONSIN_LA CROSSE,1170076618,73110198,8828.329895,13,1243186816,94.11913,7.215348
WISCONSIN_LAFAYETTE,1640985427,2539010,12654.87506,18,1643524437,99.845514,7.041364
WISCONSIN_LANGLADE,2255098198,44277567,15586.95587,25,2299375765,98.074366,6.357199
WISCONSIN_LINCOLN,2275832611,72745041,15745.39258,25,2348577652,96.902592,6.499472
WISCONSIN_MANITOWOC,1526291643,2343348501,11134.68591,17,3869640144,39.442728,16.60299
WISCONSIN_MARATHON,4001992795,80694005,28381.21491,44,4082686800,98.023507,6.580336
WISCONSIN_MARINETTE,3624599219,389876581,23929.94824,39,4014475800,90.288232,6.795885
WISCONSIN_MARQUETTE,1180288193,22670055,7941.88678,12,1202958248,98.115474,6.745357
WISCONSIN_MENOMINEE,926217566,19022479,6341.476318,10,945240045,97.98755,6.471716
WISCONSIN_MILWAUKEE,625435232,2455388970,3357.252197,5,3080824202,20.300906,33.0749
WISCONSIN_MONROE,2333329706,18586826,17582.45532,26,2351916532,99.209716,6.816351
WISCONSIN_OCONTO,2583464365,392038655,17055.00165,27,2975503020,86.824458,7.275216
WISCONSIN_ONEIDA,2885097073,317607986,19828.64594,32,3202705059,90.083133,6.878593
WISCONSIN_OUTAGAMIE,1651320404,18206595,12286.86102,19,1669526999,98.909476,6.538068
WISCONSIN_OZAUKEE,603514427,2287415379,3984.982117,6,2890929806,20.876136,31.814494
WISCONSIN_PEPIN,600894494,43241431,4744.074097,7,644135925,93.286909,7.264952
WISCONSIN_PIERCE,1486700515,48452318,10847.89551,16,1535152833,96.843811,7.000896
WISCONSIN_POLK,2368077716,109025833,17297.66992,26,2477103549,95.598657,6.95925
WISCONSIN_PORTAGE,2074258117,56829945,15543.83655,24,2131088062,97.33329,6.654043
WISCONSIN_PRICE,3247987842,62098964,22430.81671,35,3310086806,98.123948,6.531336
WISCONSIN_RACINE,861403264,1190237516,5387.848206,8,2051640780,41.986067,16.039305
WISCONSIN_RICHLAND,1518120262,8153438,11051.45654,16,1526273700,99.465795,6.944257
WISCONSIN_ROCK,1859985958,20700166,13614.52002,20,1880686124,98.899329,6.883019
WISCONSIN_RUSK,2366092053,44813690,17263.57642,26,2410905743,98.141209,6.765595
WISCONSIN_SAINT CROIX,1871147432,34271193,13471.12488,20,1905418625,98.201382,6.858588
WISCONSIN_SAUK,2153685971,45692999,17740.89179,26,2199378970,97.922459,6.968187
WISCONSIN_SAWYER,3257235817,239864619,23872.79059,37,3497100436,93.141043,6.927242
WISCONSIN_SHAWANO,2313441748,41883060,16032.18292,25,2355324808,98.221771,6.528973
WISCONSIN_SHEBOYGAN,1324851059,1967647532,7914.812012,12,3292498591,40.23847,16.39147
WISCONSIN_TAYLOR,2525371159,24634026,17852.19855,27,2550005185,99.033962,6.676422
WISCONSIN_TREMPEALEAU,1898472769,23371054,13555.35687,20,1921843823,98.783925,6.861115
WISCONSIN_VERNON,2050135745,64289526,14382.6369,21,2114425271,96.95948,7.063646
WISCONSIN_VILAS,2221451557,414422318,17087.09021,28,2635873875,84.277612,7.240989
WISCONSIN_WALWORTH,1438529014,54833465,10134.93085,15,1493362479,96.328188,7.014168
WISCONSIN_WASHBURN,2064515990,145563850,14319.46246,22,2210079840,93.413638,6.967769
WISCONSIN_WASHINGTON,1115362196,12999404,8010.074829,12,1128361600,98.84794,6.752859
WISCONSIN_WAUKESHA,1423770516,79816717,10766.67169,16,1503587233,94.691581,7.106992
WISCONSIN_WAUPACA,1936517513,45274078,12935.64905,20,1981791591,97.715498,6.619037
WISCONSIN_WAUSHARA,1621751247,29095572,10432.75134,16,1650846819,98.237537,6.637452
WISCONSIN_WINNEBAGO,1125859768,372631720,7194.828064,11,1498491488,75.132877,8.70558
WISCONSIN_WOOD,2053901351,42051649,11893.77783,18,2095953000,97.993674,6.74294
WYOMING_ALBANY,11070455501,89161376,38423.89246,116,11159616877,99.201036,3.339083
WYOMING_BIG HORN,8124681755,55228616,25090.14555,87,8179910371,99.324826,2.903529
WYOMING_CAMPBELL,12437291887,11010427,48676.14551,133,12448302314,99.911551,3.663101
WYOMING_CARBON,20455215112,171386122,73177.66867,216,20626601234,99.169101,3.417412
WYOMING_CONVERSE,11020303973,26150335,33343.89227,117,11046454308,99.763269,2.856668
WYOMING_CROOK,7393068935,28186052,37559.50934,79,7421254987,99.620198,4.772494
WYOMING_FREMONT,23785388828,212768588,76525.8967,258,23998157416,99.113396,2.992653
WYOMING_GOSHEN,5764311422,16969240,22642.39969,61,5781280662,99.70648,3.722796
WYOMING_HOT SPRINGS,5191447312,5106758,13340.76566,54,5196554070,99.901728,2.472942
WYOMING_JOHNSON,10759204099,52952166,36540.70172,115,10812156265,99.510253,3.19309
WYOMING_LARAMIE,6956354974,4348083,30475.98785,75,6960703057,99.937534,4.066005
WYOMING_LINCOLN,10555073735,49947393,37551.48779,113,10605021128,99.529021,3.338866
WYOMING_NATRONA,13831928329,90969261,38782.88138,145,13922897590,99.346621,2.692272
WYOMING_NIOBRARA,6801380673,4969450,27759.50208,72,6806350123,99.926988,3.858303
WYOMING_PARK,17972027717,67638744,69318.03241,187,18039666461,99.625055,3.725152
WYOMING_PLATTE,5390926633,76129013,18561.15219,57,5467055646,98.607495,3.302328
WYOMING_SHERIDAN,6535475106,7986330,24315.00894,66,6543461436,99.877949,3.688594
WYOMING_SUBLETTE,12655929028,127353627,43944.10498,133,12783282655,99.003749,3.337316
WYOMING_SWEETWATER,27005754251,166230252,94865.43762,286,27171984503,99.388229,3.33625
WYOMING_TETON,10351784298,570864879,45440.22769,112,10922649177,94.773568,4.280902
WYOMING_UINTA,5391631765,16625817,21057.03061,56,5408257582,99.692585,3.774782
WYOMING_WASHAKIE,5798138761,10429604,16106.38721,61,5808568365,99.820444,2.645141
WYOMING_WESTON,6210804117,5225499,27532.87732,64,6216029616,99.915935,4.305632
